Data, Hora, Fuso horário, Nome, Tipo, Status, Moeda, Valor bruto, Tarifa, Líquido, Do e-mail, Para e-mail, ID da transação, Status do equivalente, Status do endereço, Título do item, ID do item, Valor do envio e manuseio, Valor do seguro, Imposto sobre vendas, Opção 1 nome, Opção 1 valor, Opção 2 Nome, Opção 2 valor, Site do leilão, ID do comprador, URL do item, Data de término, ID txn. de referência, Número da fatura, Número personalizado, ID do recibo, Saldo, Endereço linha 1, Endereço linha 2/distrito/bairro, Cidade, Estado/Região/Território/Prefeitura/República, CEP, País, Número do telefone para contato, 
"31-01-2015","10:30:14","BRST","Moisés Batista dos Santos Filho","Pagamento Via Web Recebido","Concluído","BRL","15,00","-1,56","13,44","moisesbatista@outlook.com","rponte@triadworks.com.br","0PE17742UU988551X","Fora dos EUA - não verificado","Fora dos EUA","JavaCEDay_01","0702","0,00","","0,00","Tamanho da blusa","M-Masculina","Nome:","MoisÃ©s Batista dos Santos Filho","","","","","","","","","8.950,09","RUA SANTA INÊS  671","JACARECANGA","FORTALEZA","CE","60311-310","Brasil","",
"30-01-2015","21:18:06","BRST","Gleiton Franco","Pagamento Via Web Recebido","Concluído","BRL","15,00","-1,56","13,44","gleitonfranco@gmail.com","rponte@triadworks.com.br","9M296552HK154051Y","Fora dos EUA - não verificado","Fora dos EUA","JavaCEDay_01","0702","0,00","","0,00","Tamanho da blusa","P-Masculina","Nome:","Gleiton Soares Franco","","","","","","","","","8.936,65","Rua Arthur Da Fonseca  40  ","Vicente Pinzon","Fortaleza","CE","60181-315","Brasil","",
"30-01-2015","15:26:24","BRST","Rafael Bruno Pessoa de Araújo","Pagamento Via Web Recebido","Concluído","BRL","15,00","-1,56","13,44","rafaelbpa@gmail.com","rponte@triadworks.com.br","3VC74807KL509250Y","Fora dos EUA - verificado","Fora dos EUA","JavaCEDay_01","0702","0,00","","0,00","Tamanho da blusa","M-Masculina","Nome:","Rodrigo Parente","","","","","","","","","8.923,21","RUA HENRIQUETA GALENO 960 APARTAMENTO 1003","DIONISIO TORRES","FORTALEZA","CE","60135-420","Brasil","",
"30-01-2015","15:26:09","BRST","Lucas Falanga e Lima","Pagamento Via Web Recebido","Concluído","BRL","15,00","-1,56","13,44","lucasfalanga@gmail.com","rponte@triadworks.com.br","7HE05662WC377525L","Fora dos EUA - verificado","Fora dos EUA","JavaCEDay_01","0702","0,00","","0,00","Tamanho da blusa","P-Masculina","Nome:","Lucas Falanga","","","","","","","","","8.909,77","AVENIDA RUI BARBOSA 880 101 MEIRELES","ALDEOTA","FORTALEZA","CE","60115-221","Brasil","",
"30-01-2015","10:27:51","BRST","Valterfi Oliveira","Pagamento Via Web Recebido","Concluído","BRL","15,00","-1,56","13,44","morpheuw@gmail.com","rponte@triadworks.com.br","53X28944TR539282D","Fora dos EUA - não verificado","Fora dos EUA","JavaCEDay_01","0702","0,00","","0,00","Tamanho da blusa","M-Masculina","Nome:","Valterfi de Oliveira Costa","","","","","","","","","8.896,33","RUA GUSTAVO SAMPAIO  1871","PARQUELÂNDIA","FORTALEZA","CE","60455-001","Brasil","",
"30-01-2015","10:23:39","BRST","Adriel de Andrade Oliveira","Pagamento Via Web Recebido","Concluído","BRL","15,00","-1,56","13,44","adriel.andrade@live.com","rponte@triadworks.com.br","7EP61379KT5734706","Fora dos EUA - verificado","Fora dos EUA","JavaCEDay_01","0702","0,00","","0,00","Tamanho da blusa","M-Masculina","Nome:","Adriel Oliveira","","","","","","","","","8.882,89","AVENIDA DOS TIMBIRAS  769  BEIROL","BURITIZAL","MACAPÁ","AP","68902-872","Brasil","",
"29-01-2015","20:09:48","BRST","Felipe Alexandre da Silva","Pagamento Via Web Recebido","Concluído","BRL","15,00","-1,56","13,44","felipeas314@gmail.com","rponte@triadworks.com.br","1KT36833VD894624N","Fora dos EUA - verificado","Fora dos EUA","JavaCEDay_01","0702","0,00","","0,00","Tamanho da blusa","M-Masculina","Nome:","Felipe Alexandre da Silva","","","","","","","","","8.869,45","Rua 1  2  alameda 165","Dias Macedo","Fortaleza","CE","60860-470","Brasil","",
"29-01-2015","14:19:09","BRST","Bruno Santos Dumont de Oliveira","Pagamento Via Web Recebido","Concluído","BRL","15,00","-1,56","13,44","bruno.sdo@gmail.com","rponte@triadworks.com.br","88314601FS780130E","Fora dos EUA - verificado","Fora dos EUA","JavaCEDay_01","0702","0,00","","0,00","Tamanho da blusa","GG-Masculina","Nome:","Bruno Dumont","","","","","","","","","8.856,01","Rua Carlota Pinheiro  178  ","Guararapes","Fortaleza","CE","60810-019","Brasil","",
"29-01-2015","14:09:29","BRST","francisco araujo","Pagamento Via Web Recebido","Concluído","BRL","15,00","-1,56","13,44","wennyogatinho@hotmail.com","rponte@triadworks.com.br","2RP96674D5989373M","Fora dos EUA - não verificado","Fora dos EUA","JavaCEDay_01","0702","0,00","","0,00","Tamanho da blusa","G-Masculina","Nome:","Francisco Wendel Assis de Araujo","","","","","","","","","8.842,57","Rua Álvaro De Alencar    Em Frente A Igreja Do Evengelho Quadrangular","Carlito Pamplona","Fortaleza","CE","60311-750","Brasil","",
"29-01-2015","13:28:13","BRST","Gabriel Camara Carvalho","Pagamento Via Web Recebido","Concluído","BRL","15,00","-1,56","13,44","gabrielz_c@hotmail.com","rponte@triadworks.com.br","45L3688218721611F","Fora dos EUA - não verificado","Fora dos EUA","JavaCEDay_01","0702","0,00","","0,00","Tamanho da blusa","G-Masculina","Nome:","Gabriel Camara Carvalho","","","","","","","","","8.829,13","Rua Coronel Aluísio Borba  390  Casa 202","Engenheiro Luciano Cavalcante","Fortaleza","CE","60813-730","Brasil","",
"29-01-2015","11:52:51","BRST","Daniel Oliveira Araújo","Pagamento Via Web Recebido","Concluído","BRL","15,00","-1,56","13,44","danieloliveira14@gmail.com","rponte@triadworks.com.br","4BD980996K9059439","Fora dos EUA - não verificado","Fora dos EUA","JavaCEDay_01","0702","0,00","","0,00","Tamanho da blusa","G-Masculina","Nome:","Daniel Oliveira AraÃºjo","","","","","","","","","8.815,69","Travessa Renato Rocha  20  ","Pici","Fortaleza","CE","60440-575","Brasil","",
"29-01-2015","10:34:02","BRST","Adriano Sousa de Brito","Pagamento Via Web Recebido","Concluído","BRL","15,00","-1,56","13,44","adrianosdebrito@hotmail.com","rponte@triadworks.com.br","75E76803V22743212","Fora dos EUA - não verificado","Fora dos EUA","JavaCEDay_01","0702","0,00","","0,00","Tamanho da blusa","G-Masculina","Nome:","Adriano Brito","","","","","","","","","8.802,25","Rua Costa Sousa  71  Apartamento C","Benfica","Fortaleza","CE","60020-300","Brasil","",
"29-01-2015","10:13:50","BRST","Abel Aguiar Barroso","Pagamento Via Web Recebido","Concluído","BRL","15,00","-1,56","13,44","abel.prog@gmail.com","rponte@triadworks.com.br","7W8407686E797492U","Fora dos EUA - não verificado","Fora dos EUA","JavaCEDay_01","0702","0,00","","0,00","Tamanho da blusa","G-Masculina","Nome:","Abel Aguiar Barroso","","","","","","","","","8.788,81","Rua Anagé  991  ","Parque Guadalajara","Caucaia","CE","61650-450","Brasil","",
"29-01-2015","09:53:38","BRST","Gleidson Teixeira Rocha","Pagamento Via Web Recebido","Concluído","BRL","15,00","-1,56","13,44","gleidsondeveloper@gmail.com","rponte@triadworks.com.br","60T29598CY6090253","Fora dos EUA - não verificado","Fora dos EUA","JavaCEDay_01","0702","0,00","","0,00","Tamanho da blusa","M-Masculina","Nome:","francisco gleidson","","","","","","","","","8.775,37","Avenida Oscar Araripe  175  Altos","Bom Jardim","Fortaleza","CE","60543-452","Brasil","",
"29-01-2015","09:09:45","BRST","Abel Aguiar Barroso","Pagamento Via Web Recebido","Concluído","BRL","15,00","-1,56","13,44","abel.prog@gmail.com","rponte@triadworks.com.br","14999108SH6930629","Fora dos EUA - não verificado","Fora dos EUA","JavaCEDay_01","0702","0,00","","0,00","Tamanho da blusa","P-Feminina","Nome:","Abel Aguiar Barroso","","","","","","","","","8.761,93","Rua Anagé  991  ","Parque Guadalajara","Caucaia","CE","61650-450","Brasil","",
"29-01-2015","09:09:25","BRST","Renan Cavalcante Araujo","Pagamento Via Web Recebido","Concluído","BRL","15,00","-1,56","13,44","renancavalcantearaujo@gmail.com","rponte@triadworks.com.br","9LJ63160TR210722N","Fora dos EUA - verificado","Fora dos EUA","JavaCEDay_01","0702","0,00","","0,00","Tamanho da blusa","G-Masculina","Nome:","Davi Vieira","","","","","","","","","8.748,49","RUA TENENTE BENÉVOLO 2211 APARTAMENTO 701","MEIRELES","FORTALEZA","CE","60160-041","Brasil","",
"29-01-2015","01:11:25","BRST","Antonio Plinio Feitosa Bastos","Pagamento Via Web Recebido","Concluído","BRL","15,00","-1,56","13,44","mr.plinio@gmail.com","rponte@triadworks.com.br","7G3337466P515944A","Fora dos EUA - verificado","Fora dos EUA","JavaCEDay_01","0702","0,00","","0,00","Tamanho da blusa","G-Masculina","Nome:","","","","","","","","","","8.735,05","AVENIDA ENGENHEIRO SANTANA JÚNIOR  1345  APARTAMENTO 901B","PAPICU","FORTALEZA","CE","60175-657","Brasil","",
"28-01-2015","23:40:20","BRST","Alisson Bruno Santos","Pagamento Via Web Recebido","Concluído","BRL","15,00","-1,56","13,44","alissonbruno.sa@gmail.com","rponte@triadworks.com.br","0J205036W6205560D","Fora dos EUA - verificado","Fora dos EUA","JavaCEDay_01","0702","0,00","","0,00","Tamanho da blusa","M-Masculina","Nome:","Alisson Bruno dos Santos","","","","","","","","","8.721,61","Rua 110  114  ","Acaracuzinho","Maracanaú","CE","61920-360","Brasil","",
"28-01-2015","22:39:26","BRST","Fabio Araujo Santos","Pagamento Via Web Recebido","Concluído","BRL","15,00","-1,56","13,44","fabioaraujosantos79@gmail.com","rponte@triadworks.com.br","6UD13655BA2695052","Fora dos EUA - verificado","Fora dos EUA","JavaCEDay_01","0702","0,00","","0,00","Tamanho da blusa","M-Masculina","Nome:","Ivaldo Almada","","","","","","","","","8.708,17","Rua Suiça  120  Aptº 104 Bloco B5","Maraponga","Fortaleza","CE","60711-035","Brasil","",
"28-01-2015","22:28:38","BRST","Diego Victor Simões de Sousa","Pagamento Via Web Recebido","Concluído","BRL","15,00","-1,56","13,44","diegovss@gmail.com","rponte@triadworks.com.br","1PB843291Y984582U","Fora dos EUA - verificado","Fora dos EUA","JavaCEDay_01","0702","0,00","","0,00","Tamanho da blusa","M-Masculina","Nome:","Diego Victor SimÃµes de Sousa","","","","","","","","","8.694,73","TRAVESSA JOÃO PESSOA 6943 APARTAMENTO 826 PARANGABA","MONTESE","FORTALEZA","CE","60425-684","Brasil","",
"28-01-2015","21:34:45","BRST","Fábio Theophilo","Pagamento Via Web Recebido","Concluído","BRL","15,00","-1,56","13,44","fabiotheophilo@gmail.com","rponte@triadworks.com.br","49V20499MU354631B","Fora dos EUA - não verificado","Fora dos EUA","JavaCEDay_01","0702","0,00","","0,00","Tamanho da blusa","M-Masculina","Nome:","FÃ¡bio Marques Theophilo","","","","","","","","","8.681,29","Rua Barbosa de Freitas  300  Apt 703","Meireles","Fortaleza","CE","60170-020","Brasil","",
"28-01-2015","21:24:18","BRST","Cleria Patricia Saldanha Maia","Pagamento Via Web Recebido","Concluído","BRL","15,00","-1,56","13,44","cpsmaia@hotmail.com","rponte@triadworks.com.br","1NU72656EG748933A","Fora dos EUA - verificado","Fora dos EUA","JavaCEDay_01","0702","0,00","","0,00","Tamanho da blusa","G-Feminina","Nome:","CLERIA PATRICIA SALDANHA MAIA","","","","","","","","","8.667,85","RUA PEREIRA DE MIRANDA 1099 APARTAMENTO 2302","PAPICU","FORTALEZA","CE","60175-045","Brasil","",
"28-01-2015","20:42:37","BRST","francisco claudio pereira maia","Pagamento Via Web Recebido","Concluído","BRL","15,00","-1,56","13,44","claudiopmaia@gmail.com","rponte@triadworks.com.br","6EX54759LL554480D","Fora dos EUA - não verificado","Fora dos EUA","JavaCEDay_01","0702","0,00","","0,00","Tamanho da blusa","G-Masculina","Nome:","Claudio Maia","","","","","","","","","8.654,41","Rua Aveledo  633  ","Messejana","Fortaleza","CE","60871-210","Brasil","",
"28-01-2015","17:54:46","BRST","Franklin Barroso dos Santos","Pagamento Via Web Recebido","Concluído","BRL","15,00","-1,56","13,44","barroso.franklin@gmail.com","rponte@triadworks.com.br","2LV26816YG227382B","Fora dos EUA - verificado","Fora dos EUA","JavaCEDay_01","0702","0,00","","0,00","Tamanho da blusa","GG-Masculina","Nome:","Franklin Barroso dos Santos","","","","","","","","","8.640,97","Rua Braz De Francesco  100  Bloco 07 Apt 304","Presidente Kennedy","Fortaleza","CE","60355-633","Brasil","",
"28-01-2015","17:40:49","BRST","Altair Oliveira de Aquino","Pagamento Via Web Recebido","Concluído","BRL","15,00","-1,56","13,44","altairaquino@gmail.com","rponte@triadworks.com.br","5MA35366C1040741Y","Fora dos EUA - verificado","Fora dos EUA","JavaCEDay_01","0702","0,00","","0,00","Tamanho da blusa","M-Masculina","Nome:","Altair Aquino","","","","","","","","","8.627,53","Rua Naturalista Feijó  490  APTO 504C","Monte Castelo","Fortaleza","CE","60326-220","Brasil","",
"28-01-2015","16:02:44","BRST","Tarciso Torres","Pagamento Via Web Recebido","Concluído","BRL","15,00","-1,56","13,44","tarcisoftorres@gmail.com","rponte@triadworks.com.br","3B0717137M513501M","Fora dos EUA - não verificado","Fora dos EUA","JavaCEDay_01","0702","0,00","","0,00","Tamanho da blusa","G-Masculina","Nome:","Tarciso Torres","","","","","","","","","8.614,09","Rua 537  56  2ª Etapa","Conjunto Ceará","Fortaleza","CE","60531-430","Brasil","",
"28-01-2015","15:06:28","BRST","Andressa Araujo de Mesquita","Pagamento Via Web Recebido","Concluído","BRL","15,00","-1,56","13,44","andressaaraujo7@gmail.com","rponte@triadworks.com.br","6B600788EN6369739","Fora dos EUA - não verificado","Fora dos EUA","JavaCEDay_01","0702","0,00","","0,00","Tamanho da blusa","M--Feminina","Nome:","Isabel Nobre","","","","","","","","","8.600,65","Rua Cecil Salgado  689  A","Vila Velha","Fortaleza","CE","60346-005","Brasil","",
"28-01-2015","15:04:35","BRST","Robson de Braga Castelo Branco Junior","Pagamento Via Web Recebido","Concluído","BRL","15,00","-1,56","13,44","contato@robsonjr.com.br","rponte@triadworks.com.br","4WW09492NA479191C","Fora dos EUA - verificado","Fora dos EUA","JavaCEDay_01","0702","0,00","","0,00","Tamanho da blusa","G-Masculina","Nome:","Robson Junior","","","","","","","","","8.587,21","RUA JOSÉ VILAR 2343 APARTAMENTO 202","DIONISIO TORRES","FORTALEZA","CE","60125-001","Brasil","",
"28-01-2015","10:19:01","BRST","Matheus Fechine de Moura","Pagamento Via Web Recebido","Concluído","BRL","15,00","-1,56","13,44","mfechine@yahoo.com.br","rponte@triadworks.com.br","9VV36099PY393801W","Fora dos EUA - verificado","Fora dos EUA","JavaCEDay_01","0702","0,00","","0,00","Tamanho da blusa","M-Masculina","Nome:","Daniel Cunha","","","","","","","","","8.573,77","AVENIDA SANTOS DUMONT  2815  APARTAMENTO 4","ALDEOTA","FORTALEZA","CE","60150-161","Brasil","",
"28-01-2015","09:52:47","BRST","frederico souza soares","Pagamento Via Web Recebido","Concluído","BRL","15,00","-1,56","13,44","fredzouza@gmail.com","rponte@triadworks.com.br","47860553PB765293U","Fora dos EUA - verificado","Fora dos EUA","JavaCEDay_01","0702","0,00","","0,00","Tamanho da blusa","M-Masculina","Nome:","frederico souza soares","","","","","","","","","8.560,33","Rua Cesário Lange  549  ","Messejana","Fortaleza","CE","60841-220","Brasil","",
"28-01-2015","09:51:15","BRST","frederico souza soares","Pagamento Via Web Recebido","Concluído","BRL","15,00","-1,56","13,44","fredzouza@gmail.com","rponte@triadworks.com.br","37K3530278973604M","Fora dos EUA - verificado","Fora dos EUA","JavaCEDay_01","0702","0,00","","0,00","Tamanho da blusa","GG-Masculina","Nome:","enock pinheiro gonÃ§alves junior","","","","","","","","","8.546,89","Rua Cesário Lange  549  ","Messejana","Fortaleza","CE","60841-220","Brasil","",
"27-01-2015","21:54:13","BRST","Tiago Miranda","Pagamento Via Web Recebido","Concluído","BRL","15,00","-1,56","13,44","tiago.linhares@aluno.uece.br","rponte@triadworks.com.br","53F68290F0843263W","Fora dos EUA - verificado","Fora dos EUA","JavaCEDay_01","0702","0,00","","0,00","Tamanho da blusa","M-Masculina","Nome:","TIAGO MIRANDA LINHARES","","","","","","","","","8.533,45","Rua João Gentil  312  ","Benfica","Fortaleza","CE","60020-100","Brasil","",
"27-01-2015","21:52:29","BRST","Tiago Miranda","Pagamento Via Web Recebido","Concluído","BRL","15,00","-1,56","13,44","tiago.linhares@aluno.uece.br","rponte@triadworks.com.br","3WK63285VV859292A","Fora dos EUA - verificado","Fora dos EUA","JavaCEDay_01","0702","0,00","","0,00","Tamanho da blusa","M-Masculina","Nome:","PEDRO JORGE DE ABREU FIGUEREDO","","","","","","","","","8.520,01","Rua João Gentil  312  ","Benfica","Fortaleza","CE","60020-100","Brasil","",
"27-01-2015","20:51:18","BRST","Renan Alexandre de Almeida Lima","Pagamento Via Web Recebido","Concluído","BRL","15,00","-1,56","13,44","renan.alul@gmail.com","rponte@triadworks.com.br","8GM10647JR698011Y","Fora dos EUA - verificado","Fora dos EUA","JavaCEDay_01","0702","0,00","","0,00","Tamanho da blusa","G-Masculina","Nome:","Renan Alexandre de Almeida Lima","","","","","","","","","8.506,57","RUA FREI SERAFIM 58","PARANGABA","FORTALEZA","CE","60721-000","Brasil","",
"27-01-2015","16:53:56","BRST","Vladymir Bezerra","Pagamento Via Web Recebido","Concluído","BRL","15,00","-1,56","13,44","vladymir@outlook.com","rponte@triadworks.com.br","52X77821WR0200522","Fora dos EUA - não verificado","Fora dos EUA","JavaCEDay_01","0702","0,00","","0,00","Tamanho da blusa","M-Masculina","Nome:","Vladymir Bezerra","","","","","","","","","8.493,13","Rua Eduardo Bezerra  956  707","São João Do Tauape","Fortaleza","CE","60130-270","Brasil","",
"27-01-2015","16:22:33","BRST","RAFAELLA PARENTE LEITE","Pagamento Via Web Recebido","Concluído","BRL","15,00","-1,56","13,44","mpripardo@gmail.com","rponte@triadworks.com.br","7LA35699AK765731L","Fora dos EUA - não verificado","Fora dos EUA","JavaCEDay_01","0702","0,00","","0,00","Tamanho da blusa","P-Masculina","Nome:","Mateus Parente","","","","","","","","","8.479,69","Rua Aurino Colares  85  Casa 6","Lagoa Redonda","Fortaleza","CE","60831-435","Brasil","",
"27-01-2015","13:13:49","BRST","marcos jonathan saldanha da silva","Pagamento Via Web Recebido","Concluído","BRL","15,00","-1,56","13,44","marcosjonathansaldanha@gmail.com","rponte@triadworks.com.br","11G44467FG974001S","Fora dos EUA - não verificado","Fora dos EUA","JavaCEDay_01","0702","0,00","","0,00","Tamanho da blusa","G-Masculina","Nome:","marcos jonathan saldanha da silva","","","","","","","","","8.466,25","rua panama  76  ","Antônio bezerra","fortaleza","CE","60350-400","Brasil","",
"27-01-2015","12:36:23","BRST","Paulo Teodoro","Pagamento Via Web Recebido","Concluído","BRL","15,00","-1,56","13,44","teodoro696@hotmail.com","rponte@triadworks.com.br","6V320845G8306360H","Fora dos EUA - não verificado","Fora dos EUA","JavaCEDay_01","0702","0,00","","0,00","Tamanho da blusa","G-Masculina","Nome:","Paulo ","","","","","","","","","8.452,81","Rua Antônio Botelho  463  ","Serrinha","Fortaleza","CE","60741-110","Brasil","",
"27-01-2015","12:18:51","BRST","daniel baccin","Pagamento Via Web Recebido","Concluído","BRL","15,00","-1,56","13,44","terebaccin@gmail.com","rponte@triadworks.com.br","1LD55469RA169605U","Fora dos EUA - não verificado","Fora dos EUA","JavaCEDay_01","0702","0,00","","0,00","Tamanho da blusa","P-Masculina","Nome:","Daniel Baccin","","","","","","","","","8.439,37","av dr silas munguba  3850  apt 102b","Serrinha","Fortaleza","CE","60741-005","Brasil","",
"27-01-2015","12:01:08","BRST","Pablo Monteiro de Figueiredo","Pagamento Via Web Recebido","Concluído","BRL","15,00","-1,56","13,44","pablomf84@gmail.com","rponte@triadworks.com.br","57X15365CG885590E","Fora dos EUA - não verificado","Fora dos EUA","JavaCEDay_01","0702","0,00","","0,00","Tamanho da blusa","G-Masculina","Nome:","Sergio Danilo","","","","","","","","","8.425,93","Avenida Washington Soares  5353  Apto 304, Bl 05","José De Alencar","Fortaleza","CE","60830-005","Brasil","",
"27-01-2015","11:56:02","BRST","Enfoque Hospitalar C. P. M. H Ltda","Pagamento Via Web Recebido","Concluído","BRL","15,00","-1,56","13,44","pedro@pordotom.com.br","rponte@triadworks.com.br","53S85259DM3619946","Fora dos EUA - verificado","Fora dos EUA","JavaCEDay_01","0702","0,00","","0,00","Tamanho da blusa","M-Masculina","Nome:","Pedro Taglialatela","","","","","","","","","8.412,49","Rua Carlos Barbosa  340  ","Papicu","Fortaleza","CE","60175-355","Brasil","",
"27-01-2015","11:55:22","BRST","Andre Luiz Costa Belarmino","Pagamento Via Web Recebido","Concluído","BRL","15,00","-1,56","13,44","belarmino.andreluiz@gmail.com","rponte@triadworks.com.br","3WM63496A5321723P","Fora dos EUA - verificado","Fora dos EUA","JavaCEDay_01","0702","0,00","","0,00","Tamanho da blusa","GG-Masculina","Nome:","Andre Luiz Belarmino","","","","","","","","","8.399,05","Avenida Engenheiro Leal Lima Verde  166  ","Edson Queiroz","Fortaleza","CE","60834-385","Brasil","",
"27-01-2015","11:51:26","BRST","Pablo Monteiro de Figueiredo","Pagamento Via Web Recebido","Concluído","BRL","15,00","-1,56","13,44","pablomf84@gmail.com","rponte@triadworks.com.br","6SF16087Y61743602","Fora dos EUA - não verificado","Fora dos EUA","JavaCEDay_01","0702","0,00","","0,00","Tamanho da blusa","G-Masculina","Nome:","Pablo Monteiro de Figueiredo","","","","","","","","","8.385,61","Avenida Washington Soares  5353  Apto 304, Bl 05","José De Alencar","Fortaleza","CE","60830-005","Brasil","",
"26-01-2015","21:46:59","BRST","Denis Guedes","Pagamento Via Web Recebido","Concluído","BRL","15,00","-1,56","13,44","denisguedes23@gmail.com","rponte@triadworks.com.br","14U49333LA3149232","Fora dos EUA - não verificado","Fora dos EUA","JavaCEDay_01","0702","0,00","","0,00","Tamanho da blusa","G-Masculina","Nome:","Denis Guedes de Oliveira","","","","","","","","","8.372,17","Rua Vasco De Ataíde  551  casa terreo","Messejana","Fortaleza","CE","60841-395","Brasil","",
"26-01-2015","16:55:24","BRST","Antônio Fernandes Frota Júnior","Pagamento Via Web Recebido","Concluído","BRL","15,00","-1,56","13,44","afrotajunior@gmail.com","rponte@triadworks.com.br","20854931KK423164H","Fora dos EUA - verificado","Fora dos EUA","JavaCEDay_01","0702","0,00","","0,00","Tamanho da blusa","M-Masculina","Nome:","Antonio F Frota Junior","","","","","","","","","8.358,73","Rua Recanto Tranquilo    Ap. 102 Bl. A","Itaperi","Fortaleza","CE","60714-350","Brasil","",
"26-01-2015","15:32:08","BRST","Vitor F de B Lima","Pagamento Via Web Recebido","Concluído","BRL","15,00","-1,56","13,44","vitorfblima@gmail.com","rponte@triadworks.com.br","1MG8497523060923P","Fora dos EUA - não verificado","Fora dos EUA","JavaCEDay_01","0702","0,00","","0,00","Tamanho da blusa","G-Masculina","Nome:","Leonardo Lambiasi","","","","","","","","","8.345,29","RUA CARLOS VASCONCELOS 472","MEIRELES","FORTALEZA","CE","60115-170","Brasil","",
"26-01-2015","15:29:07","BRST","Vitor F de B Lima","Pagamento Via Web Recebido","Concluído","BRL","15,00","-1,56","13,44","vitorfblima@gmail.com","rponte@triadworks.com.br","50P72613M0730641B","Fora dos EUA - não verificado","Fora dos EUA","JavaCEDay_01","0702","0,00","","0,00","Tamanho da blusa","G-Masculina","Nome:","","","","","","","","","","8.331,85","RUA CARLOS VASCONCELOS 472","MEIRELES","FORTALEZA","CE","60115-170","Brasil","",
"26-01-2015","12:22:09","BRST","Fabio Souza de Andrade","Pagamento Via Web Recebido","Concluído","BRL","15,00","-1,56","13,44","souzace@gmail.com","rponte@triadworks.com.br","93S95538AR861244R","Fora dos EUA - verificado","Fora dos EUA","JavaCEDay_01","0702","0,00","","0,00","Tamanho da blusa","M-Masculina","Nome:","Alexssandro Oliveira Santos","","","","","","","","","8.318,41","Rua 1060  80  4ª Etapa","Conjunto Ceará","Fortaleza","CE","60533-050","Brasil","",
"25-01-2015","23:07:51","BRST","Ivo Coelho","Pagamento Via Web Recebido","Concluído","BRL","15,00","-1,56","13,44","ivocoelho.comp@gmail.com","rponte@triadworks.com.br","53H16961XD163374L","Fora dos EUA - não verificado","Fora dos EUA","JavaCEDay_01","0702","0,00","","0,00","Tamanho da blusa","P-Masculina","Nome:","Ivo Coelho Albuquerque","","","","","","","","","8.304,97","Avenida Professora Letícia Marques Cavalcante  1010  ","Capuan","Caucaia","CE","61615-000","Brasil","",
"24-01-2015","18:08:17","BRST","Joselito Viveiros Nogueira Filho","Pagamento Via Web Recebido","Concluído","BRL","15,00","-1,56","13,44","joselitofilhoo@gmail.com","rponte@triadworks.com.br","8AL56721C6886332X","Fora dos EUA - não verificado","Fora dos EUA","JavaCEDay_01","0702","0,00","","0,00","Tamanho da blusa","G-Masculina","Nome:","Joselito Viveiros Nogueira Filho","","","","","","","","","8.291,53","RUA OLIVEIRA FILHO 888","VICENTE PINZON","FORTALEZA","CE","60181-815","Brasil","",
"24-01-2015","13:02:10","BRST","Leidson Melo de Oliveira","Pagamento Via Web Recebido","Concluído","BRL","15,00","-1,56","13,44","leidson.melo@gmail.com","rponte@triadworks.com.br","2UF18242WJ841405J","Fora dos EUA - verificado","Fora dos EUA","JavaCEDay_01","0702","0,00","","0,00","Tamanho da blusa","M-Masculina","Nome:","Leidson Melo de Oliveira","","","","","","","","","8.278,09","RUA MEDELIN 3035","BOM JARDIM","FORTALEZA","CE","60540-000","Brasil","",
"24-01-2015","10:42:02","BRST","Jordi Lucas Cruz dos Santos","Pagamento Via Web Recebido","Concluído","BRL","15,00","-1,56","13,44","jordilucas3@gmail.com","rponte@triadworks.com.br","1G300478ML2840048","Fora dos EUA - não verificado","Fora dos EUA","JavaCEDay_01","0702","0,00","","0,00","Tamanho da blusa","G-Masculina","Nome:","Jordi Lucas Cruz dos Santos","","","","","","","","","8.264,65","Avenida Filomeno Gomes  100  Ap 610","Jacarecanga","Fortaleza","CE","60010-280","Brasil","",
"24-01-2015","01:19:00","BRST","Fabio Araujo Santos","Pagamento Via Web Recebido","Concluído","BRL","15,00","-1,56","13,44","fabioaraujosantos79@gmail.com","rponte@triadworks.com.br","16P76707J0512702H","Fora dos EUA - verificado","Fora dos EUA","JavaCEDay_01","0702","0,00","","0,00","Tamanho da blusa","G-Masculina","Nome:","","","","","","","","","","8.251,21","Rua Suiça  120  Aptº 104 Bloco B5","Maraponga","Fortaleza","CE","60711-035","Brasil","",
"24-01-2015","00:48:47","BRST","Luiz Carlos Borges","Pagamento Via Web Recebido","Concluído","BRL","15,00","-1,56","13,44","Joaomanoellins@gmail.com","rponte@triadworks.com.br","5WP93968MF644471X","Fora dos EUA - verificado","Fora dos EUA","JavaCEDay_01","0702","0,00","","0,00","Tamanho da blusa","GG-Masculina","Nome:","JoÃ£o Manoel Lins","","","","","","","","","8.237,77","RUA MONSENHOR CATÃO 948 APARTAMENTO 902","MEIRELES","FORTALEZA","CE","60175-000","Brasil","",
"23-01-2015","23:10:32","BRST","Levy Moreira Leite","Pagamento Via Web Recebido","Concluído","BRL","15,00","-1,56","13,44","levymoreira.ce@gmail.com","rponte@triadworks.com.br","0VF65236KU2701730","Fora dos EUA - verificado","Fora dos EUA","JavaCEDay_01","0702","0,00","","0,00","Tamanho da blusa","M-Masculina","Nome:","Levy Moreira","","","","","","","","","8.224,33","RUA SÃO MAMEDE  112A","FRANCISCANOS","JUAZEIRO DO NORTE","CE","63020-140","Brasil","",
"23-01-2015","21:25:42","BRST","Rádrick Gomes de Oliveira","Pagamento Via Web Recebido","Concluído","BRL","15,00","-1,56","13,44","radrickgomes2708@hotmail.com","rponte@triadworks.com.br","6FY37868P51896947","Fora dos EUA - não verificado","Fora dos EUA","JavaCEDay_01","0702","0,00","","0,00","Tamanho da blusa","G-Masculina","Nome:","RÃ¡drick Gomes de Oliveira","","","","","","","","","8.210,89","Avenida B  71  1 Etapa","Prefeito José Walter","Fortaleza","CE","60750-010","Brasil","",
"23-01-2015","20:14:18","BRST","Marcos Maciel","Pagamento Via Web Recebido","Concluído","BRL","15,00","-1,56","13,44","marcosmacieljr@yahoo.com.br","rponte@triadworks.com.br","044926232F7266046","Fora dos EUA - não verificado","Fora dos EUA","JavaCEDay_01","0702","0,00","","0,00","Tamanho da blusa","G-Masculina","Nome:","Marcos AntÃ´nio Silva Maciel JÃºnior","","","","","","","","","8.197,45","Rua Ana Néri  1063  apt302","Jardim América","Fortaleza","CE","60416-020","Brasil","",
"23-01-2015","19:18:22","BRST","Jorge Luiz de Queiroz","Pagamento Via Web Recebido","Concluído","BRL","15,00","-1,56","13,44","jorgellq@gmail.com","rponte@triadworks.com.br","9E465933CW2156249","Fora dos EUA - verificado","Fora dos EUA","JavaCEDay_01","0702","0,00","","0,00","Tamanho da blusa","M-Masculina","Nome:","jorge Lousada","","","","","","","","","8.184,01","RUA VICENTE LEITE 2121 APARTAMENTO 701","ALDEOTA","FORTALEZA","CE","60170-151","Brasil","",
"23-01-2015","16:01:37","BRST","Thiago Carvalho","Pagamento Via Web Recebido","Concluído","BRL","15,00","-1,56","13,44","thg.exe@gmail.com","rponte@triadworks.com.br","0V9046618E8704647","Fora dos EUA - verificado","Fora dos EUA","JavaCEDay_01","0702","0,00","","0,00","Tamanho da blusa","M-Masculina","Nome:","Thiago de Oliveira Carvalho","","","","","","","","","8.170,57","RUA DOUTOR RODRIGO CODES SANDOVAL  250  APARTAMENTO 603 TORRE BONTÁ MONDUBIM","MONDUBIM","FORTALEZA","CE","60711-455","Brasil","",
"23-01-2015","10:19:41","BRST","flavio pinto mesquita rodrigues","Pagamento Via Web Recebido","Concluído","BRL","15,00","-1,56","13,44","flaviopinto.uece@gmail.com","rponte@triadworks.com.br","88C277425S745341U","Fora dos EUA - não verificado","Fora dos EUA","JavaCEDay_01","0702","0,00","","0,00","Tamanho da blusa","P-Masculina","Nome:","FlÃ¡vio Pinto","","","","","","","","","8.157,13","RUA PADRE MÁXIMO FEITOSA  1079  ALTOS","PRESIDENTE KENNEDY","FORTALEZA","CE","60355-770","Brasil","",
"23-01-2015","10:00:49","BRST","Marcio Ramon Batista Melo da Silva","Pagamento Via Web Recebido","Concluído","BRL","15,00","-1,56","13,44","marciorbms@gmail.com","rponte@triadworks.com.br","40N36197GM8088844","Fora dos EUA - não verificado","Fora dos EUA","JavaCEDay_01","0702","0,00","","0,00","Tamanho da blusa","P-Masculina","Nome:","Marcio","","","","","","","","","8.143,69","Rua Coronel Manuel Albano, 900 - apt 502 bl01","Mondubim","Fortaleza","Ceará","60711-465","Brasil","",
"23-01-2015","09:24:31","BRST","Francisco Lee Torquato","Pagamento Via Web Recebido","Concluído","BRL","15,00","-1,56","13,44","leetor4@gmail.com","rponte@triadworks.com.br","32W211423T999361G","Fora dos EUA - não verificado","Fora dos EUA","JavaCEDay_01","0702","0,00","","0,00","Tamanho da blusa","G-Masculina","Nome:","Lee","","","","","","","","","8.130,25","Avenida João Pessoa  4736  apto 02","Damas","Fortaleza","CE","60425-812","Brasil","",
"23-01-2015","07:27:43","BRST","Belmino Jorge","Pagamento Via Web Recebido","Concluído","BRL","15,00","-1,56","13,44","belminoj@gmail.com","rponte@triadworks.com.br","49P378353T466173D","Fora dos EUA - verificado","Fora dos EUA","JavaCEDay_01","0702","0,00","","0,00","Tamanho da blusa","M-Masculina","Nome:","Belmino Leonardo Jorge","","","","","","","","","8.116,81","AVENIDA VISCONDE DO RIO BRANCO  2274  APARTAMENTO 8 FÁTIMA","JOSÉ BONIFÁCIO","FORTALEZA","CE","60055-264","Brasil","",
"22-01-2015","22:17:55","BRST","Sergio Nogueira Filho","Pagamento Via Web Recebido","Concluído","BRL","15,00","-1,56","13,44","sergiocnf@gmail.com","rponte@triadworks.com.br","2XA58165BA645442A","Fora dos EUA - verificado","Fora dos EUA","JavaCEDay_01","0702","0,00","","0,00","Tamanho da blusa","M-Masculina","Nome:","Sergio Nogueira Filho","","","","","","","","","8.103,37","Avenida Padre Antônio Tomás  3155  Apto 1501","Cocó","Fortaleza","CE","60192-120","Brasil","",
"22-01-2015","19:21:11","BRST","Ronaldo Pereira","Pagamento Via Web Recebido","Concluído","BRL","15,00","-1,56","13,44","ronaldosp83@hotmail.com","rponte@triadworks.com.br","7U5770125M765015G","Fora dos EUA - não verificado","Fora dos EUA","JavaCEDay_01","0702","0,00","","0,00","Tamanho da blusa","M-Masculina","Nome:","Ronaldo Pereira","","","","","","","","","8.089,93","Rua Irmã Cristina Maria  412  ","Outra Banda","Maranguape","CE","61942-250","Brasil","",
"22-01-2015","17:31:49","BRST","Filipe Pompeu","Pagamento Via Web Recebido","Concluído","BRL","15,00","-1,56","13,44","fisapo@gmail.com","rponte@triadworks.com.br","0DT22222W9172552H","Fora dos EUA - verificado","Fora dos EUA","JavaCEDay_01","0702","0,00","","0,00","Tamanho da blusa","M-Masculina","Nome:","Filipe Sampaio Pompeu","","","","","","","","","8.063,05","RUA ISRAEL BEZERRA 1040 APARTAMENTO 1902","DIONISIO TORRES","FORTALEZA","CE","60135-460","Brasil","",
"22-01-2015","17:31:42","BRST","Pedro S Benevides","Pagamento Via Web Recebido","Concluído","BRL","15,00","-1,56","13,44","pedro.augusto.sb@gmail.com","rponte@triadworks.com.br","56X137050J052035B","Fora dos EUA - verificado","Fora dos EUA","JavaCEDay_01","0702","0,00","","0,00","Tamanho da blusa","GG-Masculina","Nome:","Pedro Benevides","","","","","","","","","8.063,05","Rua Professor Castelo  186  ","Parque Araxá","Fortaleza","CE","60450-560","Brasil","",
"22-01-2015","17:11:53","BRST","Davi Mustafa","Pagamento Via Web Recebido","Concluído","BRL","15,00","-1,56","13,44","davi_mustafa@hotmail.com","rponte@triadworks.com.br","1HE742273E204484G","Fora dos EUA - não verificado","Fora dos EUA","JavaCEDay_01","0702","0,00","","0,00","Tamanho da blusa","M-Masculina","Nome:","Davi Mustafa de Oliveira","","","","","","","","","8.049,61","Rua Pereira Valente  111  Apartamento, 500, Pedro Lazar","Meireles","Fortaleza","CE","60160-250","Brasil","",
"22-01-2015","15:39:13","BRST","renato da silva oliceira","Pagamento Via Web Recebido","Concluído","BRL","15,00","-1,56","13,44","renatooliveira141927@gmail.com","rponte@triadworks.com.br","2KU30024MF369381U","Fora dos EUA - verificado","Fora dos EUA","JavaCEDay_01","0702","0,00","","0,00","Tamanho da blusa","M-Masculina","Nome:","RENATO DA SILVA OLIVEIRA","","","","","","","","","8.036,17","AVENIDA OSCAR ARARIPE  1558","BOM JARDIM","FORTALEZA","CE","60543-451","Brasil","",
"22-01-2015","15:37:30","BRST","Filipe Pompeu","Pagamento Via Web Recebido","Concluído","BRL","15,00","-1,56","13,44","fisapo@gmail.com","rponte@triadworks.com.br","733971033N111125H","Fora dos EUA - verificado","Fora dos EUA","JavaCEDay_01","0702","0,00","","0,00","Tamanho da blusa","P-Masculina","Nome:","Jeferson Inacio Macedo","","","","","","","","","8.022,73","RUA ISRAEL BEZERRA 1040 APARTAMENTO 1902","DIONISIO TORRES","FORTALEZA","CE","60135-460","Brasil","",
"22-01-2015","15:36:02","BRST","Paulo Roberto Mesquita","Pagamento Via Web Recebido","Concluído","BRL","15,00","-1,56","13,44","nagpaulo@gmail.com","rponte@triadworks.com.br","85X4543266881553X","Fora dos EUA - verificado","Fora dos EUA","JavaCEDay_01","0702","0,00","","0,00","Tamanho da blusa","M-Masculina","Nome:","Paulo Roberto Mesquita da Silva","","","","","","","","","8.009,29","Rua 715  154  3ª Etapa","Conjunto Ceará","Fortaleza","CE","60531-690","Brasil","",
"22-01-2015","15:34:35","BRST","Rafael da Costa Farias","Pagamento Via Web Recebido","Concluído","BRL","15,00","-1,56","13,44","rafaeldacostafarias@yahoo.com.br","rponte@triadworks.com.br","7PS1024966465421P","Fora dos EUA - verificado","Fora dos EUA","JavaCEDay_01","0702","0,00","","0,00","Tamanho da blusa","M-Masculina","Nome:","Dougllas Fco Pereira de Sousa","","","","","","","","","7.995,85","RUA 13 1561","VILA VELHA","FORTALEZA","CE","60348-360","Brasil","",
"22-01-2015","15:33:44","BRST","Rafael da Costa Farias","Pagamento Via Web Recebido","Concluído","BRL","15,00","-1,56","13,44","rafaeldacostafarias@yahoo.com.br","rponte@triadworks.com.br","7L239579GP7913745","Fora dos EUA - verificado","Fora dos EUA","JavaCEDay_01","0702","0,00","","0,00","Tamanho da blusa","M-Masculina","Nome:","Rafael","","","","","","","","","7.982,41","RUA 13 1561","VILA VELHA","FORTALEZA","CE","60348-360","Brasil","",
"22-01-2015","14:52:11","BRST","Diego Albuquerque Delmiro","Pagamento Via Web Recebido","Concluído","BRL","15,00","-1,56","13,44","diegoalbuquerque03@gmail.com","rponte@triadworks.com.br","4D218309A5492423E","Fora dos EUA - verificado","Fora dos EUA","JavaCEDay_01","0702","0,00","","0,00","Tamanho da blusa","M-Masculina","Nome:","Diego Albuquerque Delmiro","","","","","","","","","7.968,97","Rua Paurilo Barroso  209  Apr 401","Jardim Cearense","Fortaleza","CE","60712-122","Brasil","",
"22-01-2015","14:24:57","BRST","Rafael Bruno Pessoa de Araújo","Pagamento Via Web Recebido","Concluído","BRL","15,00","-1,56","13,44","rafaelbpa@gmail.com","rponte@triadworks.com.br","3D659904FY401460M","Fora dos EUA - verificado","Fora dos EUA","JavaCEDay_01","0702","0,00","","0,00","Tamanho da blusa","G-Masculina","Nome:","Rafael Araujo","","","","","","","","","7.955,53","RUA HENRIQUETA GALENO 960 APARTAMENTO 1003","DIONISIO TORRES","FORTALEZA","CE","60135-420","Brasil","",
"22-01-2015","14:15:53","BRST","MILENA RODRIGUES","Pagamento Via Web Recebido","Concluído","BRL","15,00","-1,56","13,44","rodriguesmilena.si@gmail.com","rponte@triadworks.com.br","3HW92331WC285080Y","Fora dos EUA - não verificado","Fora dos EUA","JavaCEDay_01","0702","0,00","","0,00","Tamanho da blusa","P-Feminina","Nome:","MILENA RODRIGUES REBOUÃAS","","","","","","","","","7.942,09","Rua Francisquinha Portela  1131  ","Quintino Cunha","Fortaleza","CE","60351-840","Brasil","",
"22-01-2015","14:15:10","BRST","Anderson William Silva Ventura","Pagamento Via Web Recebido","Concluído","BRL","15,00","-1,56","13,44","andwil.ce@gmail.com","rponte@triadworks.com.br","9VJ21011KH421745X","Fora dos EUA - não verificado","Fora dos EUA","JavaCEDay_01","0702","0,00","","0,00","Tamanho da blusa","M-Masculina","Nome:","Anderson William","","","","","","","","","7.928,65","Rua Doutor Pergentino Maia  2085  apartamento","Messejana","Fortaleza","CE","60840-045","Brasil","",
"22-01-2015","14:14:32","BRST","LUIZ PRUDENCIO BONDI DE SOUZA","Pagamento Via Web Recebido","Concluído","BRL","15,00","-1,56","13,44","lprud724@hotmail.com","rponte@triadworks.com.br","145158125A8614549","Fora dos EUA - verificado","Fora dos EUA","JavaCEDay_01","0702","0,00","","0,00","Tamanho da blusa","GG-Masculina","Nome:","Luiz Prudencio Bondi de Souza","","","","","","","","","7.915,21","Rua Delmiro De Farias  1021  Casa","Damas","Fortaleza","CE","60425-792","Brasil","",
"22-01-2015","13:42:38","BRST","Rodrigo Rodrigues","Pagamento Via Web Recebido","Concluído","BRL","15,00","-1,56","13,44","icq70507000@hotmail.com","rponte@triadworks.com.br","1LX86336M45015037","Fora dos EUA - verificado","Fora dos EUA","JavaCEDay_01","0702","0,00","","0,00","Tamanho da blusa","M-Masculina","Nome:","Rodrigo","","","","","","","","","7.901,77","RUA URUBURETAMA  159","PARREÃO","FORTALEZA","CE","60410-306","Brasil","",
"22-01-2015","13:36:05","BRST","Weber Militao","Pagamento Via Web Recebido","Concluído","BRL","15,00","-1,56","13,44","weber.jwm@gmail.com","rponte@triadworks.com.br","6UT21238SN434202P","Fora dos EUA - não verificado","Fora dos EUA","JavaCEDay_01","0702","0,00","","0,00","Tamanho da blusa","G-Masculina","Nome:","Weber","","","","","","","","","7.888,33","Rua Humberto Monte  1799  bloco e apartamento 203","Bela Vista","Fortaleza","CE","60442-611","Brasil","",
"22-01-2015","13:19:20","BRST","Fabio Souza de Andrade","Pagamento Via Web Recebido","Concluído","BRL","15,00","-1,56","13,44","souzace@gmail.com","rponte@triadworks.com.br","1RS83444KX091360W","Fora dos EUA - verificado","Fora dos EUA","JavaCEDay_01","0702","0,00","","0,00","Tamanho da blusa","GG-Masculina","Nome:","FÃ¡bio Souza de Andrade","","","","","","","","","7.874,89","Rua 1060  80  4ª Etapa","Conjunto Ceará","Fortaleza","CE","60533-050","Brasil","",
"22-01-2015","13:18:08","BRST","João Amílcar Viana Rodrigues","Pagamento Via Web Recebido","Concluído","BRL","15,00","-1,56","13,44","joaoamilcar@gmail.com","rponte@triadworks.com.br","345370060W830453W","Fora dos EUA - não verificado","Fora dos EUA","JavaCEDay_01","0702","0,00","","0,00","Tamanho da blusa","G-Masculina","Nome:","JoÃ£o AmÃ­lcar","","","","","","","","","7.861,45","RUA JOÃO ARARIPE  120  APARTAMENTO 203B","PARREÃO","FORTALEZA","CE","60410-356","Brasil","",
"22-01-2015","13:16:05","BRST","Bruno Bezerra","Pagamento Via Web Recebido","Concluído","BRL","15,00","-1,56","13,44","brunobezerrachaves@gmail.com","rponte@triadworks.com.br","08332980A2903294G","Fora dos EUA - verificado","Fora dos EUA","JavaCEDay_01","0702","0,00","","0,00","Tamanho da blusa","M-Masculina","Nome:","Bruno Bezerra Chaves","","","","","","","","","7.848,01","RUA DJALMA PETIT  188  AEROLÂNDIA","ALTO DA BALANÇA","FORTALEZA","CE","60851-120","Brasil","",
"22-01-2015","13:00:53","BRST","felipe aquino","Pagamento Via Web Recebido","Concluído","BRL","15,00","-1,56","13,44","aquinofb@gmail.com","rponte@triadworks.com.br","43J47316XE257940Y","Fora dos EUA - verificado","Fora dos EUA","JavaCEDay_01","0702","0,00","","0,00","Tamanho da blusa","M-Masculina","Nome:","","","","","","","","","","7.834,57","AVENIDA SANTOS DUMONT 3210 APARTAMENTO 202 BLOCO F","ALDEOTA","FORTALEZA","CE","60150-162","Brasil","",
"22-01-2015","12:56:22","BRST","Yuri Adams Chaves Maia","Pagamento Via Web Recebido","Concluído","BRL","15,00","-1,56","13,44","yuriadams@gmail.com","rponte@triadworks.com.br","0BL92001CW017211R","Fora dos EUA - verificado","Fora dos EUA","JavaCEDay_01","0702","0,00","","0,00","Tamanho da blusa","M-Masculina","Nome:","Yuri Adams","","","","","","","","","7.821,13","RUA FREI HENRIQUE  407","MESSEJANA","FORTALEZA","CE","60841-280","Brasil","",
"22-01-2015","12:16:26","BRST","Pedro Moreira Mamede","Pagamento Via Web Recebido","Concluído","BRL","15,00","-1,56","13,44","pedro.mamede@hotmail.com","rponte@triadworks.com.br","5AL64968W98672708","Fora dos EUA - não verificado","Fora dos EUA","JavaCEDay_01","0702","0,00","","0,00","Tamanho da blusa","GG-Masculina","Nome:","Pedro Mamede","","","","","","","","","7.807,69","J da penha  332  apt 503","Centro","Fortaleza","CE","60110-120","Brasil","",
"22-01-2015","11:57:26","BRST","Leonardo Daniel Tavares da Silva","Pagamento Via Web Recebido","Concluído","BRL","15,00","-1,56","13,44","ldanielts3@yahoo.com.br","rponte@triadworks.com.br","3YW28939AN614324B","Fora dos EUA - verificado","Fora dos EUA","JavaCEDay_01","0702","0,00","","0,00","Tamanho da blusa","GG-Masculina","Nome:","Leonardo Daniel Tavares da Silva","","","","","","","","","7.794,25","RUA 27  190  CASA 1 CONJUNTO POLAR","VILA VELHA","FORTALEZA","CE","60347-680","Brasil","",
"22-01-2015","11:51:59","BRST","Hedley Oria","Pagamento Via Web Recebido","Concluído","BRL","15,00","-1,56","13,44","hedleygois@gmail.com","rponte@triadworks.com.br","66A73228CE2575642","Fora dos EUA - verificado","Fora dos EUA","JavaCEDay_01","0702","0,00","","0,00","Tamanho da blusa","M-Masculina","Nome:","Hedley Luna","","","","","","","","","7.780,81","AVENIDA VIENA WEYNE 410","CAMBEBA","FORTALEZA","CE","60822-180","Brasil","",
"22-01-2015","11:31:19","BRST","Rhebecca Araujo Carneiro","Pagamento Via Web Recebido","Concluído","BRL","15,00","-1,56","13,44","rhebecca.3@gmail.com","rponte@triadworks.com.br","65K05929VP260505E","Fora dos EUA - não verificado","Fora dos EUA","JavaCEDay_01","0702","0,00","","0,00","Tamanho da blusa","GG-Masculina","Nome:","Marcio Mota","","","","","","","","","7.767,37","Rua André Chaves  100  ","Parreão","Fortaleza","CE","60410-341","Brasil","",
"22-01-2015","11:26:55","BRST","Francisco de Assis Vale Pereira","Pagamento Via Web Recebido","Concluído","BRL","15,00","-1,56","13,44","wellington.costa128@gmail.com","rponte@triadworks.com.br","2TK44577VB346305C","Fora dos EUA - não verificado","Fora dos EUA","JavaCEDay_01","0702","0,00","","0,00","Tamanho da blusa","P-Masculina","Nome:","Wellington Costa Pereira","","","","","","","","","7.753,93","Rua H  109  Delícias do sertão","Mondubim","Fortaleza","CE","60767-390","Brasil","",
"22-01-2015","11:19:19","BRST","Augusto Magalhães","Pagamento Via Web Recebido","Concluído","BRL","15,00","-1,56","13,44","augusto.cm7@gmail.com","rponte@triadworks.com.br","3G430596S4484570W","Fora dos EUA - não verificado","Fora dos EUA","JavaCEDay_01","0702","0,00","","0,00","Tamanho da blusa","GG-Masculina","Nome:","Augusto MagalhÃ£es","","","","","","","","","7.740,49","Rua Desembargador Praxedes  790  ","Bom Futuro","Fortaleza","CE","60416-172","Brasil","",
"22-01-2015","10:55:51","BRST","Thiago Bernardo","Pagamento Via Web Recebido","Concluído","BRL","15,00","-1,56","13,44","thiagobsn@gmail.com","rponte@triadworks.com.br","1PV48651CS063722J","Fora dos EUA - verificado","Fora dos EUA","JavaCEDay_01","0702","0,00","","0,00","Tamanho da blusa","GG-Masculina","Nome:","Thiago Bernardo","","","","","","","","","7.727,05","RUA CARVALHO JÚNIOR 47 TAUAPE RUA CARVALHO JUNIOR N47 TAUAPE","SÃO JOÃO DO TAUAPE","FORTALEZA","CE","60130-460","Brasil","",
"22-01-2015","10:49:19","BRST","Welluma Romagnone Barbosa Ribeiro","Pagamento Via Web Recebido","Concluído","BRL","15,00","-1,56","13,44","welluma@hotmail.com","rponte@triadworks.com.br","4JT130155T233042H","Fora dos EUA - não verificado","Fora dos EUA","JavaCEDay_01","0702","0,00","","0,00","Tamanho da blusa","M--Feminina","Nome:","Welluma Romagnone Barbosa Ribeiro","","","","","","","","","7.713,61","Rua 18  07  Conj. peq. mondubim","Mondubim","Fortaleza","CE","60762-545","Brasil","",
"22-01-2015","10:47:34","BRST","Paulo Benety Mendes de Lima","Pagamento Via Web Recebido","Concluído","BRL","15,00","-1,56","13,44","pbenety@gmail.com","rponte@triadworks.com.br","9DE41553YJ293991U","Fora dos EUA - verificado","Fora dos EUA","JavaCEDay_01","0702","0,00","","0,00","Tamanho da blusa","G-Masculina","Nome:","Paulo Benety","","","","","","","","","7.700,17","Rua 103  161  3ª Etapa","Prefeito José Walter","Fortaleza","CE","60751-150","Brasil","",
"22-01-2015","10:31:44","BRST","Jean Aragão","Pagamento Via Web Recebido","Concluído","BRL","15,00","-1,56","13,44","aragao.jean@gmail.com","rponte@triadworks.com.br","0LG36923MJ7210157","Fora dos EUA - não verificado","Fora dos EUA","JavaCEDay_01","0702","0,00","","0,00","Tamanho da blusa","G-Masculina","Nome:","Mario Diniz","","","","","","","","","7.686,73","Rua São Gerardo  300  ","Cais Do Porto","Fortaleza","CE","60180-100","Brasil","",
"22-01-2015","10:31:17","BRST","manoel neto","Pagamento Via Web Recebido","Concluído","BRL","15,00","-1,56","13,44","manoel.jfneto@gmail.com","rponte@triadworks.com.br","25G69930YE1681626","Fora dos EUA - verificado","Fora dos EUA","JavaCEDay_01","0702","0,00","","0,00","Tamanho da blusa","G-Masculina","Nome:","Manoel","","","","","","","","","7.673,29","Rua Messias Filomeno  42  ","Jacarecanga","Fortaleza","CE","60010-400","Brasil","",
"22-01-2015","10:30:56","BRST","Herbeth Milhome","Pagamento Via Web Recebido","Concluído","BRL","15,00","-1,56","13,44","h2milhome@gmail.com","rponte@triadworks.com.br","9BF83082JL318252D","Fora dos EUA - verificado","Fora dos EUA","JavaCEDay_01","0702","0,00","","0,00","Tamanho da blusa","G-Masculina","Nome:","Herbeth Milhome","","","","","","","","","7.659,85","AVENIDA CONTORNO NORTE 355 APARTAMENTO 302 BLOCO L","CONJUNTO ESPERANÇA","FORTALEZA","CE","60763-730","Brasil","",
"22-01-2015","10:30:04","BRST","Jean Aragão","Pagamento Via Web Recebido","Concluído","BRL","15,00","-1,56","13,44","aragao.jean@gmail.com","rponte@triadworks.com.br","64B597886K433671U","Fora dos EUA - não verificado","Fora dos EUA","JavaCEDay_01","0702","0,00","","0,00","Tamanho da blusa","P-Masculina","Nome:","Jean AragÃ£o","","","","","","","","","7.646,41","Rua São Gerardo  300  ","Cais Do Porto","Fortaleza","CE","60180-100","Brasil","",
"22-01-2015","10:28:26","BRST","Felipe Matos Tomaz","Pagamento Via Web Recebido","Concluído","BRL","15,00","-1,56","13,44","felipematostomaz@gmail.com","rponte@triadworks.com.br","10R50378HH455520F","Fora dos EUA - não verificado","Fora dos EUA","JavaCEDay_01","0702","0,00","","0,00","Tamanho da blusa","G-Masculina","Nome:","Felipe Matos ","","","","","","","","","7.632,97","Rua Inglaterra  449  Casa","Itaperi","Fortaleza","CE","60714-150","Brasil","",
"22-01-2015","10:23:33","BRST","Andressa Araujo de Mesquita","Pagamento Via Web Recebido","Concluído","BRL","15,00","-1,56","13,44","andressaaraujo7@gmail.com","rponte@triadworks.com.br","67233171HM7244252","Fora dos EUA - não verificado","Fora dos EUA","JavaCEDay_01","0702","0,00","","0,00","Tamanho da blusa","M--Feminina","Nome:","Andressa","","","","","","","","","7.619,53","Rua Cecil Salgado  689  A","Vila Velha","Fortaleza","CE","60346-005","Brasil","",
"22-01-2015","10:23:03","BRST","Kamilla Queiroz","Pagamento Via Web Recebido","Concluído","BRL","15,00","-1,56","13,44","kamilla_maria@hotmail.com","rponte@triadworks.com.br","3NG778781S526474P","Fora dos EUA - verificado","Fora dos EUA","JavaCEDay_01","0702","0,00","","0,00","Tamanho da blusa","P-Feminina","Nome:","Kamilla QueirÃ³z","","","","","","","","","7.606,09","RUA BRAZ DE FRANCESCO  100  SÃO GERARDO","PRESIDENTE KENNEDY","FORTALEZA","CE","60355-633","Brasil","",
"22-01-2015","10:18:54","BRST","pedro henrique moura","Pagamento Via Web Recebido","Concluído","BRL","15,00","-1,56","13,44","pedroazin@gmail.com","rponte@triadworks.com.br","80B75013R39012911","Fora dos EUA - não verificado","Fora dos EUA","JavaCEDay_01","0702","0,00","","0,00","Tamanho da blusa","GG-Masculina","Nome:","pedro henrique azin moura ","","","","","","","","","7.592,65","RUA RODRIGUES JÚNIOR 704","CENTRO","FORTALEZA","CE","60060-000","Brasil","",
"22-01-2015","10:17:43","BRST","Felipe Alves Oliveira","Pagamento Via Web Recebido","Concluído","BRL","15,00","-1,56","13,44","felipecja@gmail.com","rponte@triadworks.com.br","59942771H1270791Y","Fora dos EUA - verificado","Fora dos EUA","JavaCEDay_01","0702","0,00","","0,00","Tamanho da blusa","G-Masculina","Nome:","Raimundo Alves","","","","","","","","","7.579,21","RUA FLORÊNCIO COELHO HOLANDA 550 CASA 600","MARAPONGA","FORTALEZA","CE","60711-220","Brasil","",
"22-01-2015","10:14:02","BRST","Antonio Kleyson Prado Pereira","Pagamento Via Web Recebido","Concluído","BRL","15,00","-1,56","13,44","kleyson@msn.com","rponte@triadworks.com.br","31348563W7337700K","Fora dos EUA - verificado","Fora dos EUA","JavaCEDay_01","0702","0,00","","0,00","Tamanho da blusa","G-Masculina","Nome:","Kleyson Prado","","","","","","","","","7.565,77","RUA BRASIL OITICICA 241 APARTAMENTO 4","CAMPO DOS VELHOS","SOBRAL","CE","62030-080","Brasil","",
"20-01-2015","19:55:04","BRST","Raimundo Gomes","Pagamento de carrinho de compras recebido","Concluído","BRL","1.249,00","-161,72","1.087,28","henriquebadboy_12@hotmail.com","rponte@triadworks.com.br","0JX605794X069284U","Fora dos EUA - não verificado","Fora dos EUA","Shopping Cart","","0,00","","0,00","","","","","","","","","","","","","7.552,33","Avenida Zeze Diogo  387  ","Cais Do Porto","Fortaleza","CE","60180-012","Brasil","",
"07-01-2015","23:02:47","BRST","Thalita Monteiro Jorge","Pagamento de carrinho de compras recebido","Concluído","BRL","1.249,00","-186,70","1.062,30","temonteiroj@gmail.com","rponte@triadworks.com.br","1G098311M51040832","Fora dos EUA - não verificado","Fora dos EUA","Shopping Cart","","0,00","","0,00","","","","","","","","","","","","","6.465,05","RUA QUATORZE DE MAIO 415","BARRA DO CEARÁ","FORTALEZA","CE","60334-150","Brasil","",
"06-01-2015","14:27:54","BRST","Alura Cursos Online","Cobrança recorrente enviada","Concluído","BRL","-197,00","0,00","-197,00","rponte@triadworks.com.br","contato@alura.com.br","9YK34032GH340230E","Fora dos EUA - verificado","","","","","","","","","","","","","","","","","","","5.402,75","","","","","","","",
