Data, Hora, Fuso horário, Nome, Tipo, Status, Moeda, Valor bruto, Tarifa, Líquido, Do e-mail, Para e-mail, ID da transação, Status do equivalente, Status do endereço, Título do item, ID do item, Valor do envio e manuseio, Valor do seguro, Imposto sobre vendas, Opção 1 nome, Opção 1 valor, Opção 2 Nome, Opção 2 valor, Site do leilão, ID do comprador, URL do item, Data de término, ID da escritura, ID da fatura, ID txn. de referência, Número da fatura, Número personalizado, ID do recibo, Saldo, Endereço linha 1, Endereço linha 2/distrito/bairro, Cidade, Estado/Região/Território/Prefeitura/República, CEP, País, Número do telefone para contato, 
"30-09-2014","15:36:03","BRT","Leidson Melo de Oliveira","Pagamento Via Web Recebido","Concluído","BRL","16,00","-1,62","14,38","leidson.melo@gmail.com","rponte@triadworks.com.br","0CM029845J7283048","Fora dos EUA - verificado","Fora dos EUA","Evento JavaCE - UNIFOR","JavaCEUnifor","0,00","","0,00","Blusa","M","Nome:","Leidson Melo","","","","","","","","","","","4.651,07","RUA MEDELIN 3035","BOM JARDIM","FORTALEZA","CE","60540-000","Brasil","",
"30-09-2014","15:23:45","BRT","Lucas Moura Freitas","Pagamento Via Web Recebido","Concluído","BRL","16,00","-1,62","14,38","1lucasmf@gmail.com","rponte@triadworks.com.br","5GA796385H3949035","Fora dos EUA - verificado","Fora dos EUA","Evento JavaCE - UNIFOR","JavaCEUnifor","0,00","","0,00","Blusa","M","Nome:","Lucas Moura Freitas","","","","","","","","","","","4.636,69","Avenida Sargento Herminio Sampaio  4821  ","Antônio Bezerra","Fortaleza","CE","60350-485","Brasil","",
"30-09-2014","14:59:54","BRT","Afonso Lage","Atualização de Cheque digital recebida","Processado","BRL","16,00","-1,62","14,38","suporte@asgardmuonline.com","","3D555576LV788254E","Fora dos EUA - verificado","","","","","","","","","","","","","","","","","9RB00095MH719693R","","","","4.622,31","","","","","","","",
"30-09-2014","13:22:46","BRT","Állef Araújo Lôbo","Pagamento Via Web Recebido","Concluído","BRL","16,00","-1,62","14,38","allef.lobo@gmail.com","rponte@triadworks.com.br","43E52343XV328325X","Fora dos EUA - não verificado","Fora dos EUA","Evento JavaCE - UNIFOR","JavaCEUnifor","0,00","","0,00","Blusa","G","Nome:","ALLEF ARAUJO LOBO","","","","","","","","","","","4.607,93","Rua Dr. Rui Maia  633  apt 104","Centro","Quixadá","CE","63900-000","Brasil","",
"30-09-2014","13:10:30","BRT","Daniel Gregory Villar de Queiroz Csermak","Pagamento Via Web Recebido","Concluído","BRL","16,00","-1,62","14,38","gregory1651@hotmail.com","rponte@triadworks.com.br","8D085516EA316220E","Fora dos EUA - verificado","Fora dos EUA","Evento JavaCE - UNIFOR","JavaCEUnifor","0,00","","0,00","Blusa","GG","Nome:","GABRIEL NOBRE DE SOUZA","","","","","","","","","","","4.593,55","RUA COSTA BARROS  1651","ALDEOTA","FORTALEZA","CE","60160-281","Brasil","",
"30-09-2014","12:52:43","BRT","Paulo Teodoro","Pagamento Via Web Recebido","Concluído","BRL","16,00","-1,62","14,38","teodoro696@hotmail.com","rponte@triadworks.com.br","58D06195B0400971T","Fora dos EUA - não verificado","Fora dos EUA","Evento JavaCE - UNIFOR","JavaCEUnifor","0,00","","0,00","Blusa","P","Nome:","Mikaelly Saraiva","","","","","","","","","","","4.579,17","Rua Antônio Botelho  463  ","Serrinha","Fortaleza","CE","60741-110","Brasil","",
"30-09-2014","12:07:26","BRT","Daniel Gregory Villar de Queiroz Csermak","Pagamento Via Web Recebido","Concluído","BRL","16,00","-1,62","14,38","gregory1651@hotmail.com","rponte@triadworks.com.br","82L80005GM141802V","Fora dos EUA - verificado","Fora dos EUA","Evento JavaCE - UNIFOR","JavaCEUnifor","0,00","","0,00","Blusa","G","Nome:","Daniel Gregory Villar de Queiroz Csermak","","","","","","","","","","","4.564,79","RUA COSTA BARROS  1651","ALDEOTA","FORTALEZA","CE","60160-281","Brasil","",
"30-09-2014","11:29:40","BRT","jeferson s de azeredo","Pagamento Via Web Recebido","Concluído","BRL","16,00","-1,62","14,38","shonrpg@yahoo.com.br","rponte@triadworks.com.br","4T561031C9301963M","Fora dos EUA - não verificado","Fora dos EUA","Evento JavaCE - UNIFOR","JavaCEUnifor","0,00","","0,00","Blusa","P","Nome:","Jose William Maia Santos","","","","","","","","","","","4.550,41","Avenida I  668  ","Ancuri","Itaitinga","CE","61880-000","Brasil","",
"30-09-2014","11:15:59","BRT","Eduardo Da Silva Lopes Filho","Pagamento Via Web Recebido","Concluído","BRL","16,00","-1,62","14,38","eduardo.lopes.es@gmail.com","rponte@triadworks.com.br","41T125415M668534X","Fora dos EUA - não verificado","Fora dos EUA","Evento JavaCE - UNIFOR","JavaCEUnifor","0,00","","0,00","Blusa","P","Nome:","Francisco Wanderson Correia de Souza","","","","","","","","","","","4.536,03","Rua Antonio Pessoa De Carvalho    Mercearia Do Joaquim","Patu","Senador Pompeu","CE","63600-000","Brasil","",
"30-09-2014","11:12:47","BRT","Eduardo Da Silva Lopes Filho","Pagamento Via Web Recebido","Concluído","BRL","16,00","-1,62","14,38","eduardo.lopes.es@gmail.com","rponte@triadworks.com.br","6M4175899M580915D","Fora dos EUA - não verificado","Fora dos EUA","Evento JavaCE - UNIFOR","JavaCEUnifor","0,00","","0,00","Blusa","P","Nome:","Gustavo Aires Matos","","","","","","","","","","","4.521,65","Rua Antonio Pessoa De Carvalho    Mercearia Do Joaquim","Patu","Senador Pompeu","CE","63600-000","Brasil","",
"30-09-2014","11:12:19","BRT","Giancarlo Lucciani Lopes","Pagamento Via Web Recebido","Concluído","BRL","16,00","-1,62","14,38","giancarlolucciani@gmail.com","rponte@triadworks.com.br","5VB13914H14529800","Fora dos EUA - não verificado","Fora dos EUA","Evento JavaCE - UNIFOR","JavaCEUnifor","0,00","","0,00","Blusa","M","Nome:","Giancarlo Lucciani","","","","","","","","","","","4.507,27","RUA DOUTOR HÉLIO VIANA 155","SÃO GERARDO","FORTALEZA","CE","60320-240","Brasil","",
"30-09-2014","11:11:48","BRT","Eduardo Da Silva Lopes Filho","Pagamento Via Web Recebido","Concluído","BRL","16,00","-1,62","14,38","eduardo.lopes.es@gmail.com","rponte@triadworks.com.br","4HG45919UA149084Y","Fora dos EUA - não verificado","Fora dos EUA","Evento JavaCE - UNIFOR","JavaCEUnifor","0,00","","0,00","Blusa","GG","Nome:","JosÃ© Murilo de Oliveira JÃºnior","","","","","","","","","","","4.492,89","Rua Antonio Pessoa De Carvalho    Mercearia Do Joaquim","Patu","Senador Pompeu","CE","63600-000","Brasil","",
"30-09-2014","11:09:28","BRT","Eduardo Da Silva Lopes Filho","Pagamento Via Web Recebido","Concluído","BRL","16,00","-1,62","14,38","eduardo.lopes.es@gmail.com","rponte@triadworks.com.br","7LR83484BT7893530","Fora dos EUA - não verificado","Fora dos EUA","Evento JavaCE - UNIFOR","JavaCEUnifor","0,00","","0,00","Blusa","P","Nome:","Eduardo da Silva Lopes Filho","","","","","","","","","","","4.478,51","Rua Antonio Pessoa De Carvalho    Mercearia Do Joaquim","Patu","Senador Pompeu","CE","63600-000","Brasil","",
"30-09-2014","11:05:54","BRT","daniel de c martins","Pagamento Via Web Recebido","Concluído","BRL","16,00","-1,62","14,38","dcarvalhomartins@hotmail.com","rponte@triadworks.com.br","9JX36729J46976248","Fora dos EUA - verificado","Fora dos EUA","Evento JavaCE - UNIFOR","JavaCEUnifor","0,00","","0,00","Blusa","G","Nome:","DANIEL DE CARVALHO MARTINS","","","","","","","","","","","4.464,13","Rua 212  321  casa","Jangurussu","Fortaleza","CE","60866-250","Brasil","",
"30-09-2014","10:49:52","BRT","jeferson s de azeredo","Pagamento Via Web Recebido","Concluído","BRL","16,00","-1,62","14,38","shonrpg@yahoo.com.br","rponte@triadworks.com.br","16R749730X006974K","Fora dos EUA - não verificado","Fora dos EUA","Evento JavaCE - UNIFOR","JavaCEUnifor","0,00","","0,00","Blusa","M","Nome:","Jeferson Stankowski de Azeredo","","","","","","","","","","","4.449,75","Avenida I  668  ","Ancuri","Itaitinga","CE","61880-000","Brasil","",
"30-09-2014","10:19:53","BRT","Augusto Magalhães","Pagamento Via Web Recebido","Concluído","BRL","16,00","-1,62","14,38","augusto.cm7@gmail.com","rponte@triadworks.com.br","26R309799V240503N","Fora dos EUA - não verificado","Fora dos EUA","Evento JavaCE - UNIFOR","JavaCEUnifor","0,00","","0,00","Blusa","GG","Nome:","Augusto MagalhÃ£es","","","","","","","","","","","4.435,37","Rua Desembargador Praxedes  790  ","Bom Futuro","Fortaleza","CE","60416-172","Brasil","",
"30-09-2014","09:35:01","BRT","Leandro Holanda Torres","Pagamento Via Web Recebido","Concluído","BRL","16,00","-1,62","14,38","leandroholanda@outlook.com","rponte@triadworks.com.br","2DJ52854XA939203U","Fora dos EUA - verificado","Fora dos EUA","Evento JavaCE - UNIFOR","JavaCEUnifor","0,00","","0,00","Blusa","M","Nome:","Leandro Holanda Torres","","","","","","","","","","","4.420,99","Travessa José Viana de Sousa  171  171A , No Duplex","Centro","Quixadá","CE","63900-000","Brasil","",
"30-09-2014","09:19:47","BRT","ailton nascimento","Pagamento Via Web Recebido","Concluído","BRL","16,00","-1,62","14,38","tym.ailton@gmail.com","rponte@triadworks.com.br","8V981235TF142092G","Fora dos EUA - não verificado","Fora dos EUA","Evento JavaCE - UNIFOR","JavaCEUnifor","0,00","","0,00","Blusa","M","Nome:","Ailton","","","","","","","","","","","4.406,61","Estrada Nova  457  ","Vila Serpa","Aquiraz","CE","61700-000","Brasil","",
"30-09-2014","00:30:06","BRT","Paulo Teodoro","Pagamento Via Web Recebido","Concluído","BRL","16,00","-1,62","14,38","teodoro696@hotmail.com","rponte@triadworks.com.br","2CH77955HE337035N","Fora dos EUA - não verificado","Fora dos EUA","Evento JavaCE - UNIFOR","JavaCEUnifor","0,00","","0,00","Blusa","G","Nome:","Paulo Teodoro","","","","","","","","","","","4.392,23","Rua Antônio Botelho  463  ","Serrinha","Fortaleza","CE","60741-110","Brasil","",
"29-09-2014","22:48:42","BRT","Yago Alves","Pagamento Via Web Recebido","Concluído","BRL","16,00","-1,62","14,38","yago.alves105@gmail.com","rponte@triadworks.com.br","13303033HR999042P","Fora dos EUA - não verificado","Fora dos EUA","Evento JavaCE - UNIFOR","JavaCEUnifor","0,00","","0,00","Blusa","P","Nome:","Wellington Lucas ","","","","","","","","","","","4.377,85","Coronel Luiz Duarte  142  Na ladeira do Banco do Brasil","Centro","Jucás","CE","63580-000","Brasil","",
"29-09-2014","22:32:09","BRT","Eugênio Brito","Pagamento Via Web Recebido","Concluído","BRL","16,00","-1,62","14,38","eugeniobac@gmail.com","rponte@triadworks.com.br","7A3201822R285540K","Fora dos EUA - verificado","Fora dos EUA","Evento JavaCE - UNIFOR","JavaCEUnifor","0,00","","0,00","Blusa","G","Nome:","EugÃªnio Brito de AraÃºjo Costa","","","","","","","","","","","4.363,47","RUA NELSON MACHADO 14","AMADEU FURTADO","FORTALEZA","CE","60455-580","Brasil","",
"29-09-2014","22:29:29","BRT","Luís Gustavo Coutinho do Rêgo","Pagamento Via Web Recebido","Concluído","BRL","16,00","-1,62","14,38","gustavolgcr@gmail.com","rponte@triadworks.com.br","3WE225837K2399512","Fora dos EUA - verificado","Fora dos EUA","Evento JavaCE - UNIFOR","JavaCEUnifor","0,00","","0,00","Blusa","M","Nome:","LuÃ­s Gustavo Coutinho do RÃªgo","","","","","","","","","","","4.349,09","Rua Dom Sebastião Leme  699  Apto 201","Fátima","Fortaleza","CE","60050-160","Brasil","",
"29-09-2014","22:13:13","BRT","Wagner Dantas Fernandes","Pagamento Via Web Recebido","Concluído","BRL","16,00","-1,62","14,38","wagnerfernandes1986@gmail.com","rponte@triadworks.com.br","5XB40203HA379101V","Fora dos EUA - verificado","Fora dos EUA","Evento JavaCE - UNIFOR","JavaCEUnifor","0,00","","0,00","Blusa","P","Nome:","Francisco Wagner Dantas Fernandes","","","","","","","","","","","4.334,71","AVENIDA MONSENHOR TABOSA  206A  APARTAMENTO 316","CENTRO","FORTALEZA","CE","60165-010","Brasil","",
"29-09-2014","21:20:44","BRT","RAFAELLA PARENTE LEITE","Pagamento Via Web Recebido","Concluído","BRL","16,00","-1,62","14,38","mpripardo@gmail.com","rponte@triadworks.com.br","5SA44821UR239614C","Fora dos EUA - não verificado","Fora dos EUA","Evento JavaCE - UNIFOR","JavaCEUnifor","0,00","","0,00","Blusa","P","Nome:","Mateus Parente Ripardo Oliveira","","","","","","","","","","","4.320,33","Rua Aurino Colares  85  Casa 6","Lagoa Redonda","Fortaleza","CE","60831-435","Brasil","",
"29-09-2014","18:41:42","BRT","Françoes da Silva Pereira","Pagamento Via Web Recebido","Concluído","BRL","16,00","-1,62","14,38","fsp.engenharia@gmail.com","rponte@triadworks.com.br","71H66360WP473831D","Fora dos EUA - não verificado","Fora dos EUA","Evento JavaCE - UNIFOR","JavaCEUnifor","0,00","","0,00","Blusa","P","Nome:","FranÃ§oes da Silva Pereira","","","","","","","","","","","4.305,95","Rua São Tiago  560  casa","Pajuçara","Maracanaú","CE","61932-180","Brasil","",
"29-09-2014","18:24:39","BRT","Yago Alves","Pagamento Via Web Recebido","Concluído","BRL","16,00","-1,62","14,38","yago.alves105@gmail.com","rponte@triadworks.com.br","8KB904260S678220G","Fora dos EUA - não verificado","Fora dos EUA","Evento JavaCE - UNIFOR","JavaCEUnifor","0,00","","0,00","Blusa","G","Nome:","Yago Alves da Silva ","","","","","","","","","","","4.291,57","Coronel Luiz Duarte  142  Na ladeira do Banco do Brasil","Centro","Jucás","CE","63580-000","Brasil","",
"29-09-2014","16:50:41","BRT","Leandro Souza","Pagamento Via Web Recebido","Concluído","BRL","16,00","-1,62","14,38","leandro_souza_@hotmail.com","rponte@triadworks.com.br","6XU98523HU988752U","Fora dos EUA - não verificado","Fora dos EUA","Evento JavaCE - UNIFOR","JavaCEUnifor","0,00","","0,00","Blusa","M","Nome:","Rafael Cruz Oliveira","","","","","","","","","","","4.277,19","RUA PADRE MORORÓ  795  CASA 10","CENTRO","FORTALEZA","CE","60015-220","Brasil","",
"29-09-2014","16:47:15","BRT","Leandro Souza","Pagamento Via Web Recebido","Concluído","BRL","16,00","-1,62","14,38","leandro_souza_@hotmail.com","rponte@triadworks.com.br","7A108530198197505","Fora dos EUA - não verificado","Fora dos EUA","Evento JavaCE - UNIFOR","JavaCEUnifor","0,00","","0,00","Blusa","G","Nome:","Leandro Souza de Araujo Alves","","","","","","","","","","","4.262,81","RUA PADRE MORORÓ  795  CASA 10","CENTRO","FORTALEZA","CE","60015-220","Brasil","",
"29-09-2014","15:50:05","BRT","Tiago Freire Alves","Pagamento Via Web Recebido","Concluído","BRL","16,00","-1,62","14,38","tiagowd@gmail.com","rponte@triadworks.com.br","674315429F304243D","Fora dos EUA - verificado","Fora dos EUA","Evento JavaCE - UNIFOR","JavaCEUnifor","0,00","","0,00","Blusa","M","Nome:","Tiago Freire","","","","","","","","","","","4.248,43","AVENIDA PASTEUR 1116 APARTAMENTO 301A","ÁLVARO WEYNE","FORTALEZA","CE","60335-000","Brasil","",
"29-09-2014","15:46:43","BRT","João Amílcar Viana Rodrigues","Pagamento Via Web Recebido","Concluído","BRL","16,00","-1,62","14,38","joaoamilcar@gmail.com","rponte@triadworks.com.br","3K388064SJ915042Y","Fora dos EUA - não verificado","Fora dos EUA","Evento JavaCE - UNIFOR","JavaCEUnifor","0,00","","0,00","Blusa","G","Nome:","JoÃ£o AmÃ­lcar Viana Rodrigues","","","","","","","","","","","4.234,05","RUA JOÃO ARARIPE  120  APARTAMENTO 203B","PARREÃO","FORTALEZA","CE","60410-356","Brasil","",
"29-09-2014","15:41:12","BRT","Renan Alexandre de Almeida Lima","Pagamento Via Web Recebido","Concluído","BRL","16,00","-1,62","14,38","renan.alul@gmail.com","rponte@triadworks.com.br","64B861809P890310D","Fora dos EUA - verificado","Fora dos EUA","Evento JavaCE - UNIFOR","JavaCEUnifor","0,00","","0,00","Blusa","G","Nome:","Renan Alexandre de Almeida Lima","","","","","","","","","","","4.219,67","RUA FREI SERAFIM 58","PARANGABA","FORTALEZA","CE","60721-000","Brasil","",
"29-09-2014","12:25:38","BRT","Wemy Vieira Felipe","Pagamento Via Web Recebido","Concluído","BRL","16,00","-1,62","14,38","wemyfelype@hotmail.com","rponte@triadworks.com.br","60E51531BV206864E","Fora dos EUA - não verificado","Fora dos EUA","Evento JavaCE - UNIFOR","JavaCEUnifor","0,00","","0,00","Blusa","G","Nome:","Wemy","","","","","","","","","","","4.205,29","Rua Abdom Galdino  2062  ","centro","cascavel","CE","62850-000","Brasil","",
"29-09-2014","11:30:25","BRT","frederico souza soares","Pagamento Via Web Recebido","Concluído","BRL","16,00","-1,62","14,38","fredzouza@gmail.com","rponte@triadworks.com.br","3RB26693N99660902","Fora dos EUA - verificado","Fora dos EUA","Evento JavaCE - UNIFOR","JavaCEUnifor","0,00","","0,00","Blusa","G","Nome:","FRANCISCO ERINALDO SILVA DE SOUZA","","","","","","","","","","","4.190,91","Rua Cesário Lange  549  ","Messejana","Fortaleza","CE","60841-220","Brasil","",
"29-09-2014","10:43:21","BRT","Bruno Santos Dumont de Oliveira","Pagamento Via Web Recebido","Concluído","BRL","16,00","-1,62","14,38","bruno.sdo@gmail.com","rponte@triadworks.com.br","38779887YL969184F","Fora dos EUA - verificado","Fora dos EUA","Evento JavaCE - UNIFOR","JavaCEUnifor","0,00","","0,00","Blusa","GG","Nome:","Bruno Dumont","","","","","","","","","","","4.176,53","Avenida Beco Eugênio Bezerra  100  Q02 , C25","São Francisco","Rio Branco","AC","69901-519","Brasil","",
"29-09-2014","10:33:52","BRT","Eliezer Nascimento","Pagamento Via Web Recebido","Concluído","BRL","16,00","-1,62","14,38","leoscottk2010@gmail.com","rponte@triadworks.com.br","2TU8168101607450M","Fora dos EUA - verificado","Fora dos EUA","Evento JavaCE - UNIFOR","JavaCEUnifor","0,00","","0,00","Blusa","M","Nome:","Carlos Henrique Rodrigues Bezerra","","","","","","","","","","","4.162,15","RUA MARIA NEIVA 37 3","VILA VELHA","FORTALEZA","CE","60349-235","Brasil","",
"29-09-2014","09:40:03","BRT","Hedley Oria","Pagamento Via Web Recebido","Concluído","BRL","16,00","-1,62","14,38","hedleygois@gmail.com","rponte@triadworks.com.br","1SN45743S85939821","Fora dos EUA - verificado","Fora dos EUA","Evento JavaCE - UNIFOR","JavaCEUnifor","0,00","","0,00","Blusa","P","Nome:","Ivo Coelho","","","","","","","","","","","4.147,77","AVENIDA VIENA WEYNE 410","CAMBEBA","FORTALEZA","CE","60822-180","Brasil","",
"29-09-2014","09:32:04","BRT","Jefferson Teixeira Gonçalves","Pagamento Via Web Recebido","Concluído","BRL","16,00","-1,62","14,38","jeffersontg@yahoo.com.br","rponte@triadworks.com.br","8YK25045RT365460M","Fora dos EUA - verificado","Fora dos EUA","Evento JavaCE - UNIFOR","JavaCEUnifor","0,00","","0,00","Blusa","G","Nome:","JEFFERSON TEIXEIRA GONÃALVES","","","","","","","","","","","4.133,39","Rua Esperanto  535  AP 203B","Parreão","Fortaleza","CE","60410-312","Brasil","",
"29-09-2014","09:15:27","BRT","Diego Masin","Pagamento Via Web Recebido","Concluído","BRL","16,00","-1,62","14,38","diegoifce@yahoo.com.br","rponte@triadworks.com.br","7D721527PX364182H","Fora dos EUA - não verificado","Fora dos EUA","Evento JavaCE - UNIFOR","JavaCEUnifor","0,00","","0,00","Blusa","M","Nome:","Tiago de Oliveira Vale","","","","","","","","","","","4.119,01","Rua Barba Alardo  724  ","Serrinha","Fortaleza","CE","60741-040","Brasil","",
"29-09-2014","09:04:22","BRT","Diego Masin","Pagamento Via Web Recebido","Concluído","BRL","16,00","-1,62","14,38","diegoifce@yahoo.com.br","rponte@triadworks.com.br","7N094608113370541","Fora dos EUA - não verificado","Fora dos EUA","Evento JavaCE - UNIFOR","JavaCEUnifor","0,00","","0,00","Blusa","M","Nome:","Diego Teixeira de Masin","","","","","","","","","","","4.104,63","Rua Barba Alardo  724  ","Serrinha","Fortaleza","CE","60741-040","Brasil","",
"29-09-2014","08:33:13","BRT","Evaldo Junior","Pagamento Via Web Recebido","Concluído","BRL","16,00","-1,62","14,38","evaldojr2@gmail.com","rponte@triadworks.com.br","4WD889035N9213913","Fora dos EUA - verificado","Fora dos EUA","Evento JavaCE - UNIFOR","JavaCEUnifor","0,00","","0,00","Blusa","P","Nome:","Jordi Lucas","","","","","","","","","","","4.090,25","AVENIDA FILOMENO GOMES 100 APARTAMENTO 610","JACARECANGA","FORTALEZA","CE","60010-280","Brasil","",
"29-09-2014","08:31:30","BRT","Evaldo Junior","Pagamento Via Web Recebido","Concluído","BRL","16,00","-1,62","14,38","evaldojr2@gmail.com","rponte@triadworks.com.br","2KS410762F669924C","Fora dos EUA - verificado","Fora dos EUA","Evento JavaCE - UNIFOR","JavaCEUnifor","0,00","","0,00","Blusa","M","Nome:","Evaldo Sabtis","","","","","","","","","","","4.075,87","AVENIDA FILOMENO GOMES 100 APARTAMENTO 610","JACARECANGA","FORTALEZA","CE","60010-280","Brasil","",
"29-09-2014","08:13:57","BRT","rui jose","Pagamento Via Web Recebido","Concluído","BRL","16,00","-1,62","14,38","ruijosecj@gmail.com","rponte@triadworks.com.br","2DC46626030414352","Fora dos EUA - não verificado","Fora dos EUA","Evento JavaCE - UNIFOR","JavaCEUnifor","0,00","","0,00","Blusa","G","Nome:","rui jose","","","","","","","","","","","4.061,49","Rua Maria Amália  349  casa A","Passaré","Fortaleza","CE","60862-020","Brasil","",
"29-09-2014","08:09:22","BRT","Francisco Vanderson da Silva Santos","Pagamento Via Web Recebido","Concluído","BRL","16,00","-1,62","14,38","vandersonsilva@outlook.com","rponte@triadworks.com.br","0T0220628V274260X","Fora dos EUA - não verificado","Fora dos EUA","Evento JavaCE - UNIFOR","JavaCEUnifor","0,00","","0,00","Blusa","M","Nome:","Francisco Vanderson da Silva Santos","","","","","","","","","","","4.047,11","Rua Piauí  129  ","Cônego Raimundo Pinto","Maranguape","CE","61945-200","Brasil","",
"29-09-2014","07:27:04","BRT","Francisco Aquino","Pagamento Via Web Recebido","Concluído","BRL","16,00","-1,62","14,38","jader.aquino@redeinova.net","rponte@triadworks.com.br","0P2085575M818573E","Fora dos EUA - verificado","Fora dos EUA","Evento JavaCE - UNIFOR","JavaCEUnifor","0,00","","0,00","Blusa","GG","Nome:","Jader","","","","","","","","","","","4.032,73","Rua Romeu Martins  345  ap 303","Montese","Fortaleza","CE","60420-720","Brasil","",
"29-09-2014","07:16:30","BRT","Francisco Aquino","Pagamento Via Web Recebido","Concluído","BRL","16,00","-1,62","14,38","jader.aquino@redeinova.net","rponte@triadworks.com.br","25A18478LV7443350","Fora dos EUA - verificado","Fora dos EUA","Evento JavaCE - UNIFOR","JavaCEUnifor","0,00","","0,00","Blusa","GG","Nome:","Fonseca","","","","","","","","","","","4.018,35","Rua Romeu Martins  345  ap 303","Montese","Fortaleza","CE","60420-720","Brasil","",
"28-09-2014","23:18:38","BRT","danilo raimundo da silva","Pagamento Via Web Recebido","Concluído","BRL","16,00","-1,62","14,38","danilo170@hotmail.com","rponte@triadworks.com.br","3LD55188MB2359340","Fora dos EUA - não verificado","Fora dos EUA","Evento JavaCE - UNIFOR","JavaCEUnifor","0,00","","0,00","Blusa","M","Nome:","danilo da silva","","","","","","","","","","","4.003,97","Rua Das Crianças  146  ","Cristo Redentor","Fortaleza","CE","60337-430","Brasil","",
"28-09-2014","22:43:05","BRT","giovanne ferreira de oliveira","Pagamento Via Web Recebido","Concluído","BRL","16,00","-1,62","14,38","giovannefd@gmail.com","rponte@triadworks.com.br","567091554D547372D","Fora dos EUA - não verificado","Fora dos EUA","Evento JavaCE - UNIFOR","JavaCEUnifor","0,00","","0,00","Blusa","M","Nome:","joao paulo de farias","","","","","","","","","","","3.989,59","RUA NOVA VIDA  75","ARIANÓPOLIS (JUREMA)","CAUCAIA","CE","61656-060","Brasil","",
"28-09-2014","20:31:17","BRT","Gilderlandio P","Pagamento Via Web Recebido","Concluído","BRL","16,00","-1,62","14,38","meloangelim@gmail.com","rponte@triadworks.com.br","8RM31027W0638541M","Fora dos EUA - não verificado","Fora dos EUA","Evento JavaCE - UNIFOR","JavaCEUnifor","0,00","","0,00","Blusa","M","Nome:","Francisco Filipe Angelim de Melo","","","","","","","","","","","3.975,21","Rua Bom Jesus  872  Altos","Bom Jardim","Fortaleza","CE","60540-250","Brasil","",
"28-09-2014","18:34:55","BRT","Riosney Santos do Vale","Pagamento Via Web Recebido","Concluído","BRL","16,00","-1,62","14,38","riosney_s@hotmail.com","rponte@triadworks.com.br","7EP89075VJ8602938","Fora dos EUA - verificado","Fora dos EUA","Evento JavaCE - UNIFOR","JavaCEUnifor","0,00","","0,00","Blusa","M","Nome:","Riosney Santos","","","","","","","","","","","3.960,83","Rua Osiá Montenegro  215  casa 79","Siqueira","Fortaleza","CE","60732-544","Brasil","",
"28-09-2014","17:50:05","BRT","giovanne ferreira de oliveira","Pagamento Via Web Recebido","Concluído","BRL","16,00","-1,62","14,38","giovannefd@gmail.com","rponte@triadworks.com.br","04L14046SW508563P","Fora dos EUA - não verificado","Fora dos EUA","Evento JavaCE - UNIFOR","JavaCEUnifor","0,00","","0,00","Blusa","M","Nome:","giovanne ferreira de oliveira","","","","","","","","","","","3.946,45","RUA NOVA VIDA  75","ARIANÓPOLIS (JUREMA)","CAUCAIA","CE","61656-060","Brasil","",
"28-09-2014","16:24:09","BRT","MAURICIO MORAIS DE OLIVEIRA","Pagamento Via Web Recebido","Concluído","BRL","16,00","-1,62","14,38","mauriciomorais@mmodeveloper.com.br","rponte@triadworks.com.br","4XF33661RY427474D","Fora dos EUA - não verificado","Fora dos EUA","Evento JavaCE - UNIFOR","JavaCEUnifor","0,00","","0,00","Blusa","GG","Nome:","MaurÃ­cio Morais de Oliveira","","","","","","","","","","","3.932,07","Avenida Rogaciano Leite  1060  APTO 703","Salinas","Fortaleza","CE","60810-786","Brasil","",
"28-09-2014","15:07:25","BRT","renan alves","Pagamento Via Web Recebido","Concluído","BRL","16,00","-1,62","14,38","renanlvesdeveloper@gmail.com","rponte@triadworks.com.br","42462536YG1273452","Fora dos EUA - não verificado","Fora dos EUA","Evento JavaCE - UNIFOR","JavaCEUnifor","0,00","","0,00","Blusa","G","Nome:","Renan Alves","","","","","","","","","","","3.917,69","Rua Carlos Gondim  738  ","Vila Velha","Fortaleza","CE","60347-055","Brasil","",
"28-09-2014","12:41:58","BRT","Afonso Lage","Pagamento Via Web Recebido","Processado","BRL","16,00","-1,62","14,38","suporte@asgardmuonline.com","rponte@triadworks.com.br","9RB00095MH719693R","Fora dos EUA - verificado","Fora dos EUA","Evento JavaCE - UNIFOR","JavaCEUnifor","0,00","","0,00","Blusa","GG","Nome:","Afonso Lage","","","","","","","","","","","3.903,31","RUA MIMOSA  140  ALTOS","MONTESE","FORTALEZA","CE","60410-230","Brasil","",
"28-09-2014","12:30:38","BRT","Welluma Romagnone Barbosa Ribeiro","Pagamento Via Web Recebido","Concluído","BRL","16,00","-1,62","14,38","welluma@hotmail.com","rponte@triadworks.com.br","88Y68327A8886171U","Fora dos EUA - não verificado","Fora dos EUA","Evento JavaCE - UNIFOR","JavaCEUnifor","0,00","","0,00","Blusa","P","Nome:","Welluma Romagnone Barbosa Ribeiro","","","","","","","","","","","3.903,31","Rua 18  07  Conj. peq. mondubim","Mondubim","Fortaleza","CE","60762-545","Brasil","",
"28-09-2014","12:20:34","BRT","ANTONIO ALVES LOPES FILHO ALVES","Pagamento Via Web Recebido","Concluído","BRL","16,00","-1,62","14,38","tonalveslopes@gmail.com","rponte@triadworks.com.br","6RL67475M97723413","Fora dos EUA - não verificado","Fora dos EUA","Evento JavaCE - UNIFOR","JavaCEUnifor","0,00","","0,00","Blusa","M","Nome:","Antonio Alves Lopes filho","","","","","","","","","","","3.888,93","Travessa Altenor Almeida  1010  CASA","Floresta","Fortaleza","CE","60340-493","Brasil","",
"28-09-2014","11:51:25","BRT","Priscilla Rayane Bezerra Carneiro","Pagamento Via Web Recebido","Concluído","BRL","16,00","-1,62","14,38","cicero_roniel@hotmail.com","rponte@triadworks.com.br","6AG79548SA916173N","Fora dos EUA - não verificado","Fora dos EUA","Evento JavaCE - UNIFOR","JavaCEUnifor","0,00","","0,00","Blusa","M","Nome:","CÃ­cero Roniel Bezerra Carneiro","","","","","","","","","","","3.874,55","Rua Miguel Afonso Silva  1470  ","Siqueira","Fortaleza","CE","60732-552","Brasil","",
"28-09-2014","10:15:21","BRT","Francisco de Assis Vale Pereira","Pagamento Via Web Recebido","Concluído","BRL","16,00","-1,62","14,38","wellington.costa128@gmail.com","rponte@triadworks.com.br","2VC981377D836931Y","Fora dos EUA - não verificado","Fora dos EUA","Evento JavaCE - UNIFOR","JavaCEUnifor","0,00","","0,00","Blusa","P","Nome:","Wellington Costa Pereira","","","","","","","","","","","3.860,17","Rua H  109  Delícias do sertão","Mondubim","Fortaleza","CE","60767-390","Brasil","",
"27-09-2014","23:16:18","BRT","Wilmerson da Silva Cunha","Pagamento Via Web Recebido","Concluído","BRL","16,00","-1,62","14,38","wilmersondasilva@gmail.com","rponte@triadworks.com.br","92070974V54817222","Fora dos EUA - não verificado","Fora dos EUA","Evento JavaCE - UNIFOR","JavaCEUnifor","0,00","","0,00","Blusa","M","Nome:","Wilmerson da Silva Cunha","","","","","","","","","","","3.845,79","Rua Josmo Gurgel Araújo  898  ","Centro","Itaitinga","CE","61880-000","Brasil","",
"27-09-2014","19:24:06","BRT","Caio Melo","Pagamento Via Web Recebido","Concluído","BRL","16,00","-1,62","14,38","caio.compufc@gmail.com","rponte@triadworks.com.br","64F24533X9163322E","Fora dos EUA - não verificado","Fora dos EUA","Evento JavaCE - UNIFOR","JavaCEUnifor","0,00","","0,00","Blusa","G","Nome:","Caio Albuquerque Melo","","","","","","","","","","","3.831,41","Rua Padre Guerra  2677  301B","Parquelândia","Fortaleza","CE","60455-365","Brasil","",
"27-09-2014","19:05:30","BRT","LUIZ PRUDENCIO BONDI DE SOUZA","Pagamento Via Web Recebido","Concluído","BRL","16,00","-1,62","14,38","lprud724@hotmail.com","rponte@triadworks.com.br","3HY911069M084072F","Fora dos EUA - verificado","Fora dos EUA","Evento JavaCE - UNIFOR","JavaCEUnifor","0,00","","0,00","Blusa","GG","Nome:","Luiz Prudencio Bondi de Souza","","","","","","","","","","","3.817,03","Rua Delmiro De Farias  1021  Casa","Damas","Fortaleza","CE","60425-792","Brasil","",
"27-09-2014","16:34:28","BRT","Jose Lenilton Coelho Jr","Pagamento Via Web Recebido","Concluído","BRL","16,00","-1,62","14,38","leniltonjr@hotmail.com","rponte@triadworks.com.br","5N297471XA154650W","Fora dos EUA - não verificado","Fora dos EUA","Evento JavaCE - UNIFOR","JavaCEUnifor","0,00","","0,00","Blusa","GG","Nome:","Lenilton Jr.","","","","","","","","","","","3.802,65","Rua Homem De Melo  815  C-02","Cambeba","Fortaleza","CE","60822-345","Brasil","",
"27-09-2014","16:18:18","BRT","Thiago Carvalho","Pagamento Via Web Recebido","Concluído","BRL","16,00","-1,62","14,38","thg.exe@gmail.com","rponte@triadworks.com.br","60T57856U7836140D","Fora dos EUA - verificado","Fora dos EUA","Evento JavaCE - UNIFOR","JavaCEUnifor","0,00","","0,00","Blusa","M","Nome:","Thiago Carvalho","","","","","","","","","","","3.788,27","RUA DOUTOR RODRIGO CODES SANDOVAL  250  APARTAMENTO 603 TORRE BONTÁ MONDUBIM","MONDUBIM","FORTALEZA","CE","60711-455","Brasil","",
"27-09-2014","11:03:01","BRT","frederico souza soares","Pagamento Via Web Recebido","Concluído","BRL","16,00","-1,62","14,38","fredzouza@gmail.com","rponte@triadworks.com.br","0EC462929R8161404","Fora dos EUA - verificado","Fora dos EUA","Evento JavaCE - UNIFOR","JavaCEUnifor","0,00","","0,00","Blusa","M","Nome:","frederico souza soares","","","","","","","","","","","3.773,89","Rua Cesário Lange  549  ","Messejana","Fortaleza","CE","60841-220","Brasil","",
"27-09-2014","06:53:58","BRT","Eduardo Pereira","Pagamento Via Web Recebido","Concluído","BRL","16,00","-1,62","14,38","eduardoromcy@gmail.com","rponte@triadworks.com.br","8KA50524AC236114E","Fora dos EUA - verificado","Fora dos EUA","Evento JavaCE - UNIFOR","JavaCEUnifor","0,00","","0,00","Blusa","G","Nome:","Eduardo Romcy Pereira ","","","","","","","","","","","3.759,51","RUA DATIVA BARRETO 71","HENRIQUE JORGE","FORTALEZA","CE","60510-260","Brasil","",
"26-09-2014","23:14:50","BRT","Sávio Lima","Pagamento Via Web Recebido","Concluído","BRL","16,00","-1,62","14,38","savioliima@outlook.com.br","rponte@triadworks.com.br","98E06225SY8335702","Fora dos EUA - não verificado","Fora dos EUA","Evento JavaCE - UNIFOR","JavaCEUnifor","0,00","","0,00","Blusa","P","Nome:","SÃ¡vio Lima","","","","","","","","","","","3.745,13","Rua Martins Carvalho  1868  ","Granja Lisboa","Fortaleza","CE","60540-178","Brasil","",
"26-09-2014","22:32:24","BRT","Rodrigo Rodrigues","Pagamento Via Web Recebido","Concluído","BRL","16,00","-1,62","14,38","icq70507000@hotmail.com","rponte@triadworks.com.br","6T256495G8193441Y","Fora dos EUA - verificado","Fora dos EUA","Evento JavaCE - UNIFOR","JavaCEUnifor","0,00","","0,00","Blusa","M","Nome:","Rodrigo Sousa","","","","","","","","","","","3.730,75","RUA URUBURETAMA  159","PARREÃO","FORTALEZA","CE","60410-306","Brasil","",
"26-09-2014","21:28:17","BRT","Winston Nunes de Lima","Pagamento Via Web Recebido","Concluído","BRL","16,00","-1,62","14,38","winstonrm@gmail.com","rponte@triadworks.com.br","2CL881643E6223729","Fora dos EUA - verificado","Fora dos EUA","Evento JavaCE - UNIFOR","JavaCEUnifor","0,00","","0,00","Blusa","G","Nome:","Winston Nunes de Lima","","","","","","","","","","","3.716,37","RUA CAPITÃO FRANCISCO PEDRO  506  85","RODOLFO TEÓFILO","FORTALEZA","CE","60430-375","Brasil","",
"26-09-2014","21:16:41","BRT","Charles Duarte do Nascimento","Pagamento Via Web Recebido","Concluído","BRL","16,00","-1,62","14,38","charlesduarte04@gmail.com","rponte@triadworks.com.br","4YJ12480E5949803E","Fora dos EUA - não verificado","Fora dos EUA","Evento JavaCE - UNIFOR","JavaCEUnifor","0,00","","0,00","Blusa","GG","Nome:","Charles Duarte do Nascimento","","","","","","","","","","","3.701,99","Rua Coronel João Licínio  312  Altos","Itambé","Caucaia","CE","61602-080","Brasil","",
"26-09-2014","21:08:13","BRT","Pablo Monteiro de Figueiredo","Pagamento Via Web Recebido","Concluído","BRL","16,00","-1,62","14,38","pablomf84@gmail.com","rponte@triadworks.com.br","4H894708GV4194003","Fora dos EUA - não verificado","Fora dos EUA","Evento JavaCE - UNIFOR","JavaCEUnifor","0,00","","0,00","Blusa","G","Nome:","Pablo Monteiro de FIgueiredo","","","","","","","","","","","3.687,61","Avenida Washington Soares  5353  Apto 304, Bl 05","José De Alencar","Fortaleza","CE","60830-005","Brasil","",
"26-09-2014","20:14:05","BRT","Bruno Bezerra","Pagamento Via Web Recebido","Concluído","BRL","16,00","-1,62","14,38","brunobezerrachaves@gmail.com","rponte@triadworks.com.br","90X11354B7236422D","Fora dos EUA - verificado","Fora dos EUA","Evento JavaCE - UNIFOR","JavaCEUnifor","0,00","","0,00","Blusa","G","Nome:","Bruno Bezerra Chaves","","","","","","","","","","","3.673,23","RUA DJALMA PETIT  188  AEROLÂNDIA","ALTO DA BALANÇA","FORTALEZA","CE","60851-120","Brasil","",
"26-09-2014","20:07:29","BRT","Paulo José da Rocha Costa","Pagamento Via Web Recebido","Concluído","BRL","16,00","-1,62","14,38","pjrc83@gmail.com","rponte@triadworks.com.br","76R17622W6393560G","Fora dos EUA - não verificado","Fora dos EUA","Evento JavaCE - UNIFOR","JavaCEUnifor","0,00","","0,00","Blusa","GG","Nome:","Paulo Costa","","","","","","","","","","","3.658,85","Rua Doutor Pedro Sampaio  170  Casa","Passaré","Fortaleza","CE","60861-500","Brasil","",
"26-09-2014","18:06:04","BRT","Alexandre Araujo","Pagamento Via Web Recebido","Concluído","BRL","16,00","-1,62","14,38","alexandre.little@gmail.com","rponte@triadworks.com.br","1B748818W0902384C","Fora dos EUA - verificado","Fora dos EUA","Evento JavaCE - UNIFOR","JavaCEUnifor","0,00","","0,00","Blusa","P","Nome:","Alexandre AraÃºjo","","","","","","","","","","","3.644,47","RUA PAPI JÚNIOR 2190","BELA VISTA","FORTALEZA","CE","60441-690","Brasil","",
"26-09-2014","17:53:50","BRT","Pedro Moreira Mamede","Pagamento Via Web Recebido","Concluído","BRL","16,00","-1,62","14,38","pedro.mamede@hotmail.com","rponte@triadworks.com.br","0KG018813A636624L","Fora dos EUA - não verificado","Fora dos EUA","Evento JavaCE - UNIFOR","JavaCEUnifor","0,00","","0,00","Blusa","GG","Nome:","Pedro Mamede","","","","","","","","","","","3.630,09","J da penha  332  apt 503","Centro","Fortaleza","CE","60110-120","Brasil","",
"26-09-2014","17:31:02","BRT","Pedro Afonso de Oliveira Guimarães","Pagamento Via Web Recebido","Concluído","BRL","16,00","-1,62","14,38","pedroaoguimaraes@gmail.com","rponte@triadworks.com.br","8UW43074103708838","Fora dos EUA - não verificado","Fora dos EUA","Evento JavaCE - UNIFOR","JavaCEUnifor","0,00","","0,00","Blusa","M","Nome:","Pedro Afonso de Oliveira GuimarÃ£es","","","","","","","","","","","3.615,71","Rua Paulo Morais  720  apto 903 Bloco A","Papicu","Fortaleza","CE","60175-175","Brasil","",
"26-09-2014","17:10:26","BRT","Paulo Benety Mendes de Lima","Pagamento Via Web Recebido","Concluído","BRL","16,00","-1,62","14,38","pbenety@gmail.com","rponte@triadworks.com.br","5AR12334DY157725L","Fora dos EUA - verificado","Fora dos EUA","Evento JavaCE - UNIFOR","JavaCEUnifor","0,00","","0,00","Blusa","G","Nome:","Paulo Benety","","","","","","","","","","","3.601,33","Rua 103  161  3ª Etapa","Prefeito José Walter","Fortaleza","CE","60751-150","Brasil","",
"26-09-2014","16:50:14","BRT","Francisco Reginaldo Alexandre da Silva Reginaldo","Pagamento Via Web Recebido","Concluído","BRL","16,00","-1,62","14,38","regisalex2011@gmail.com","rponte@triadworks.com.br","6VF476297J669520N","Fora dos EUA - não verificado","Fora dos EUA","Evento JavaCE - UNIFOR","JavaCEUnifor","0,00","","0,00","Blusa","G","Nome:","Francisco Reginaldo Alexandre da Silva","","","","","","","","","","","3.586,95","Rua 1159  117  4 etapa","Conjunto Ceará","Fortaleza","CE","60533-540","Brasil","",
"26-09-2014","16:35:38","BRT","Antonio Kleyson Prado Pereira","Pagamento Via Web Recebido","Concluído","BRL","16,00","-1,62","14,38","kleyson@msn.com","rponte@triadworks.com.br","8HR09479XN091772J","Fora dos EUA - verificado","Fora dos EUA","Evento JavaCE - UNIFOR","JavaCEUnifor","0,00","","0,00","Blusa","P","Nome:","Kleyson Prado ","","","","","","","","","","","3.572,57","RUA BRASIL OITICICA 241 APARTAMENTO 4","CAMPO DOS VELHOS","SOBRAL","CE","62030-080","Brasil","",
"26-09-2014","15:58:41","BRT","Tiago Germano Pereira","Pagamento Via Web Recebido","Concluído","BRL","16,00","-1,62","14,38","tiagogermanos@gmail.com","rponte@triadworks.com.br","2E936978S0610361U","Fora dos EUA - não verificado","Fora dos EUA","Evento JavaCE - UNIFOR","JavaCEUnifor","0,00","","0,00","Blusa","M","Nome:","Tiago Germano Pereira","","","","","","","","","","","3.558,19","Avenida I  251  AP 308 BL 05","Jereissati I","Maracanaú","CE","61900-410","Brasil","",
"26-09-2014","15:54:23","BRT","Felipe Matos Tomaz","Pagamento Via Web Recebido","Concluído","BRL","16,00","-1,62","14,38","felipematostomaz@gmail.com","rponte@triadworks.com.br","83558086GH993283J","Fora dos EUA - não verificado","Fora dos EUA","Evento JavaCE - UNIFOR","JavaCEUnifor","0,00","","0,00","Blusa","G","Nome:","Felipe Matos Tomaz","","","","","","","","","","","3.543,81","Rua Inglaterra  449  Casa","Itaperi","Fortaleza","CE","60714-150","Brasil","",
"26-09-2014","15:54:05","BRT","Henrique Luz Pereira","Pagamento Via Web Recebido","Concluído","BRL","16,00","-1,62","14,38","riqueluz@gmail.com","rponte@triadworks.com.br","4CA91717CV4878747","Fora dos EUA - verificado","Fora dos EUA","Evento JavaCE - UNIFOR","JavaCEUnifor","0,00","","0,00","Blusa","P","Nome:","Henrique Luz","","","","","","","","","","","3.529,43","RUA ALEXANDRE BARAÚNA  1294  APARTAMENTO 201 RODOLFO TEÓFILO","RODOLFO TEÓFILO","FORTALEZA","CE","60430-160","Brasil","",
"26-09-2014","15:41:13","BRT","Hedley Oria","Pagamento Via Web Recebido","Concluído","BRL","16,00","-1,62","14,38","hedleygois@gmail.com","rponte@triadworks.com.br","38A09099JK051404W","Fora dos EUA - verificado","Fora dos EUA","Evento JavaCE - UNIFOR","JavaCEUnifor","0,00","","0,00","Blusa","M","Nome:","Hedley Luna","","","","","","","","","","","3.515,05","AVENIDA VIENA WEYNE 410","CAMBEBA","FORTALEZA","CE","60822-180","Brasil","",
"26-09-2014","15:33:35","BRT","Henriqiue Neto","Pagamento Via Web Recebido","Concluído","BRL","16,00","-1,62","14,38","henrique_mino@yahoo.com.br","rponte@triadworks.com.br","52E4207773636914R","Fora dos EUA - não verificado","Fora dos EUA","Evento JavaCE - UNIFOR","JavaCEUnifor","0,00","","0,00","Blusa","G","Nome:","Paulo Franklim","","","","","","","","","","","3.500,67","Rua General Alípio Dos Santos  98  ","Olavo Oliveira","Fortaleza","CE","60351-105","Brasil","",
"26-09-2014","15:23:48","BRT","Anderson Rodrigues de Sousa","Pagamento Via Web Recebido","Concluído","BRL","16,00","-1,62","14,38","anddersonrs@icloud.com","rponte@triadworks.com.br","3CH97343BP604721N","Fora dos EUA - não verificado","Fora dos EUA","Evento JavaCE - UNIFOR","JavaCEUnifor","0,00","","0,00","Blusa","M","Nome:","Anderson","","","","","","","","","","","3.486,29","Rua Joaquim Pimenta  189  ","Montese","Fortaleza","CE","60410-220","Brasil","",
"26-09-2014","15:13:36","BRT","SAMUEL SANTOS","Pagamento Via Web Recebido","Concluído","BRL","16,00","-1,62","14,38","sanmoo.cs@gmail.com","rponte@triadworks.com.br","9CS54302CE2279523","Fora dos EUA - não verificado","Fora dos EUA","Evento JavaCE - UNIFOR","JavaCEUnifor","0,00","","0,00","Blusa","GG","Nome:","Samuel Carvalho Santos","","","","","","","","","","","3.471,91","Rua Padre Sá Leitão  55  ","Henrique Jorge","Fortaleza","CE","60521-032","Brasil","",
"26-09-2014","14:56:11","BRT","Fellipe Hallanny Silva Batista","Pagamento Via Web Recebido","Concluído","BRL","16,00","-1,62","14,38","kiwilbj@gmail.com","rponte@triadworks.com.br","72Y59695VC783434G","Fora dos EUA - verificado","Fora dos EUA","Evento JavaCE - UNIFOR","JavaCEUnifor","0,00","","0,00","Blusa","G","Nome:","Fellipe Hallanny Silva Batista","","","","","","","","","","","3.457,53","RUA 729 231","CONJUNTO CEARÁ","FORTALEZA","CE","60531-760","Brasil","",
"26-09-2014","14:52:52","BRT","maria de fatima costa","Pagamento Via Web Recebido","Concluído","BRL","16,00","-1,62","14,38","carloshilner@gmail.com","rponte@triadworks.com.br","7KF01103EV301102R","Fora dos EUA - verificado","Fora dos EUA","Evento JavaCE - UNIFOR","JavaCEUnifor","0,00","","0,00","Blusa","GG","Nome:","Carlos Hilner Ferreira Costa","","","","","","","","","","","3.443,15","RUA ALMIRANTE RUFINO 1089 APARTAMENTO 704 T 2","VILA UNIÃO","FORTALEZA","CE","60420-075","Brasil","",
"26-09-2014","14:52:18","BRT","Henriqiue Neto","Pagamento Via Web Recebido","Concluído","BRL","16,00","-1,62","14,38","henrique_mino@yahoo.com.br","rponte@triadworks.com.br","0FD2908338502921G","Fora dos EUA - não verificado","Fora dos EUA","Evento JavaCE - UNIFOR","JavaCEUnifor","0,00","","0,00","Blusa","G","Nome:","Henrique Neto","","","","","","","","","","","3.428,77","Rua General Alípio Dos Santos  98  ","Olavo Oliveira","Fortaleza","CE","60351-105","Brasil","",
"26-09-2014","14:49:24","BRT","Iuri Costa Freire","Pagamento Via Web Recebido","Concluído","BRL","16,00","-1,62","14,38","iuricostafreire@gmail.com","rponte@triadworks.com.br","9PV29188JV921371U","Fora dos EUA - verificado","Fora dos EUA","Evento JavaCE - UNIFOR","JavaCEUnifor","0,00","","0,00","Blusa","G","Nome:","Iuri Costa Freire","","","","","","","","","","","3.414,39","RUA RIO NEGRO 226 APARTAMENTO 512","TABAPUÁ","CAUCAIA","CE","61635-025","Brasil","",
"26-09-2014","14:45:03","BRT","Paulo Glauber Sousa Lima","Pagamento Via Web Recebido","Concluído","BRL","16,00","-1,62","14,38","pauloglauber@gmail.com","rponte@triadworks.com.br","1UT02768MW293963B","Fora dos EUA - não verificado","Fora dos EUA","Evento JavaCE - UNIFOR","JavaCEUnifor","0,00","","0,00","Blusa","P","Nome:","Paulo Glauber de Sousa Lima","","","","","","","","","","","3.400,01","Rua Caramuru  264  ","Serrinha","Fortaleza","CE","60742-175","Brasil","",
"26-09-2014","14:44:48","BRT","Franklin Barroso dos Santos","Pagamento Via Web Recebido","Concluído","BRL","16,00","-1,62","14,38","barroso.franklin@gmail.com","rponte@triadworks.com.br","0X225562FD505422B","Fora dos EUA - verificado","Fora dos EUA","Evento JavaCE - UNIFOR","JavaCEUnifor","0,00","","0,00","Blusa","GG","Nome:","Franklin Barroso dos Santos","","","","","","","","","","","3.385,63","Rua Braz De Francesco  100  Bloco 07 Apt 304","Presidente Kennedy","Fortaleza","CE","60355-633","Brasil","",
"26-09-2014","14:43:19","BRT","Adriano Sousa de Brito","Pagamento Via Web Recebido","Concluído","BRL","16,00","-1,62","14,38","adrianosdebrito@hotmail.com","rponte@triadworks.com.br","7EU700595J2163908","Fora dos EUA - não verificado","Fora dos EUA","Evento JavaCE - UNIFOR","JavaCEUnifor","0,00","","0,00","Blusa","M","Nome:","Adriano Sousa de Brito","","","","","","","","","","","3.371,25","Rua Costa Sousa  71  Apartamento C","Benfica","Fortaleza","CE","60020-300","Brasil","",
"26-09-2014","14:39:39","BRT","DAVID BANHOS","Pagamento Via Web Recebido","Concluído","BRL","16,00","-1,62","14,38","david.banhos@gmail.com","rponte@triadworks.com.br","4W711198GX363704M","Fora dos EUA - verificado","Fora dos EUA","Evento JavaCE - UNIFOR","JavaCEUnifor","0,00","","0,00","Blusa","M","Nome:","David Saggese Banhos","","","","","","","","","","","3.356,87","Rua Izídio José Campina  480  ","Tamatanduba","Eusébio","CE","61760-000","Brasil","",
"26-09-2014","14:38:52","BRT","nelson costa","Pagamento Via Web Recebido","Concluído","BRL","16,00","-1,62","14,38","nelsoncostasn@gmail.com","rponte@triadworks.com.br","55B36619YK464190C","Fora dos EUA - verificado","Fora dos EUA","Evento JavaCE - UNIFOR","JavaCEUnifor","0,00","","0,00","Blusa","M","Nome:","Nelson Costa","","","","","","","","","","","3.342,49","Rua Frei Vidal  1952  ","São João Do Tauape","Fortaleza","CE","60120-100","Brasil","",
"26-09-2014","14:29:23","BRT","Marcelo Bezerra Diniz","Pagamento Via Web Recebido","Concluído","BRL","16,00","-1,62","14,38","marceloemanoel@gmail.com","rponte@triadworks.com.br","0MM627679C042902D","Fora dos EUA - verificado","Fora dos EUA","Evento JavaCE - UNIFOR","JavaCEUnifor","0,00","","0,00","Blusa","G","Nome:","Marcelo Emanoel B. Diniz","","","","","","","","","","","3.328,11","RUA JOÃO ARARIPE 60 APARTAMENTO 603 A","PARREÃO","FORTALEZA","CE","60410-356","Brasil","",
"26-09-2014","14:23:43","BRT","Bruno Alves cau","Pagamento Via Web Recebido","Concluído","BRL","16,00","-1,62","14,38","Brunoalcau@gmail.com","rponte@triadworks.com.br","6RT94469A9002804H","Fora dos EUA - verificado","Fora dos EUA","Evento JavaCE - UNIFOR","JavaCEUnifor","0,00","","0,00","Blusa","G","Nome:","bruno alves cau","","","","","","","","","","","3.313,73","Rua Albano Amaral  211  ","Manuel Sátiro","Fortaleza","CE","60713-200","Brasil","",
"26-09-2014","14:19:46","BRT","Efraim Gentil","Pagamento Via Web Recebido","Concluído","BRL","16,00","-1,62","14,38","efraimgentil@gmail.com","rponte@triadworks.com.br","4E454750C3661403H","Fora dos EUA - verificado","Fora dos EUA","Evento JavaCE - UNIFOR","JavaCEUnifor","0,00","","0,00","Blusa","M","Nome:","Efraim Gentil de Goes Filho","","","","","","","","","","","3.299,35","RUA LAURO MAIA 999 APARTAMENTO 604 BLOCO 2","JOSÉ BONIFÁCIO","FORTALEZA","CE","60055-210","Brasil","",
"26-09-2014","14:08:06","BRT","Radams Silva","Pagamento Via Web Recebido","Concluído","BRL","16,00","-1,62","14,38","radamssilva@gmail.com","rponte@triadworks.com.br","0KJ16267MF567651M","Fora dos EUA - verificado","Fora dos EUA","Evento JavaCE - UNIFOR","JavaCEUnifor","0,00","","0,00","Blusa","M","Nome:","Radams Silva","","","","","","","","","","","3.284,97","Avenida Juscelino Kubitschek  3750  Apartamento 311, Bloco B, Condomínio Villa Rubi","Passaré","Fortaleza","CE","60861-634","Brasil","",
"26-09-2014","14:07:01","BRT","Paulo Henrique Alves","Pagamento Via Web Recebido","Concluído","BRL","16,00","-1,62","14,38","paulohenriqueas13@gmail.com","rponte@triadworks.com.br","17K352057D860663B","Fora dos EUA - verificado","Fora dos EUA","Evento JavaCE - UNIFOR","JavaCEUnifor","0,00","","0,00","Blusa","M","Nome:","Paulo Henrique Alves","","","","","","","","","","","3.270,59","RUA DEODATO SARAIVA DA SILVA 293","PARQUE DAS PAINEIRAS","SÃO PAULO","SP","03694-090","Brasil","",
"26-09-2014","14:06:13","BRT","Alisson Bruno Santos","Pagamento Via Web Recebido","Concluído","BRL","16,00","-1,62","14,38","alissonbruno.sa@gmail.com","rponte@triadworks.com.br","167847489M034802U","Fora dos EUA - não verificado","Fora dos EUA","Evento JavaCE - UNIFOR","JavaCEUnifor","0,00","","0,00","Blusa","M","Nome:","Alisson Bruno dos Santos","","","","","","","","","","","3.241,83","Rua 110  114  ","Acaracuzinho","Maracanaú","CE","61920-360","Brasil","",
"26-09-2014","14:06:08","BRT","Geissivan Falcão","Pagamento Via Web Recebido","Concluído","BRL","16,00","-1,62","14,38","geissivan@gmail.com","rponte@triadworks.com.br","8P922260SW1763705","Fora dos EUA - verificado","Fora dos EUA","Evento JavaCE - UNIFOR","JavaCEUnifor","0,00","","0,00","Blusa","G","Nome:","Geissivan Peroba FalcÃ£o","","","","","","","","","","","3.241,83","Rua José Venâncio  351","Centro","Aquiraz","CE","61700-000","Brasil","",
"26-09-2014","14:05:11","BRT","Francisco Otávio Landim Conrado","Pagamento Via Web Recebido","Concluído","BRL","16,00","-1,62","14,38","otavio.landim@gmail.com","rponte@triadworks.com.br","9BK072366U815802P","Fora dos EUA - verificado","Fora dos EUA","Evento JavaCE - UNIFOR","JavaCEUnifor","0,00","","0,00","Blusa","GG","Nome:","Francisco OtÃ¡vio Landim Conrado","","","","","","","","","","","3.227,45","Rua 3 - Cond Jardim das Margaridas  350  T10 AP 301","Pedras","Fortaleza","CE","60878-045","Brasil","",
